Mm, Mm, Mm, Mm, Mm, Mm, Mm, Mm, Mm, Mm, Mm, Gg, Hh^Fds, Gg, Gs^Fds, Gs^Fds, Re, Gg, Gs^Fds, Gs^Fds, Gs^Fds, Mm, Mm, Mm, Mm, Mm, Mm, Mm, Wwt, Hh^Fds
Mm, Mm, Ce, Mm, Ce, Mm, Mm, Mm, Mm, Mm, Mm, Hh^Fds, Hh^Fds, Hh^Fds, Gs^Fds, Gs^Fds, Re, Gll, Gs^Fds, Gs^Fds, Gs^Fds, Mm, Mm, Mm, Mm, Mm, Hh^Fds, Hh^Fds, Wwt, Wwt
Mm, Mm, Ce, Ce, Ce, Mm, Mm, Mm, Mm, Mm, Mm, Hh^Fds, Hh^Fds, Hh^Fds, Gs^Fds, Gs^Fds, Gll, Re, Gs^Fds, Gs^Fds, Mm^Xm, Mm, Mm, Mm, Hh^Fds, Hh^Fds, Wwt, Wwt, Hh^Fds, Hh^Fds
Mm, Mm, Ce, 3 Ke, Ce, Mm, Mm, Mm, Mm, Mm, Hh^Fds, Hh^Fds, Hh^Fds, Hh^Fds, Gs^Fds, Gs^Fds, Re, Re, Gs^Fds, Mm, Mm, Mm, Mm^Xm, Mm, Hh^Fds, Hh^Fds, Wwt, Hh^Fds, Hh^Fds, Mm
Mm, Mm, Mm, Ce, Gg, Gg, Gg, Mm, Hh^Fds, Hh^Fds, Hh^Fds, Hh^Fds, Hh^Fds, Hh^Fds, Gs^Fds, Kw, Re, Kw, Gs^Fds, Mm, Mm^Xm, Mm^Xm, Mm, Mm, Hh^Fds, Wwt, Hh^Fds, Hh^Fds, Mm, Mm
Mm, Mm, Mm, Mm, Mm, Gg, Gg, Gg, Hh^Fds, Hh^Fds, Hh^Fds, Hh^Fds, Gg, Gg, Gg, Gg, Re, Gs^Fds, Gs^Fds, Mm, Mm, Mm, Mm, Mm, Wwt, Wwt, Mm, Mm, Mm, Mm
Mm, Mm, Mm, Mm, Mm, Gg, Gg, Gg, Gg^Vws, Hh^Fds, Hh^Fds, Gg, Gg, Gg, Gg^Vws, Re, Gg, Gg, Gs^Fds, Gs^Fds, Gs^Fds, Mm, Wwt, Wwt, Mm, Mm, Mm, Mm, Mm, Mm
Mm, Mm, Mm, Mm, Mm, Gg, Gg, Gg, Gg, Hh^Fds, Gg, Gg, Re, Re, Gg, Gg, Gg, Gg, Gg, Gs^Fds, Gs^Fds, Gs^Fds, Wwt, Wwt, Mm, Mm, Mm, Mm, Mm, Mm
Mm, Mm, Mm, Mm, Hh^Fds, Gg^Vws, Hh^Fds, Gg, Gs, Gg, Re, Re, Gg^Efm, Gg^Efm, Gg^Efm, Gg, Gg, Gg, Gg, Gg, Gs^Fds, Wwt, Gs^Fds, Gs^Fds, Mm, Mm, Mm, Mm, Mm, Mm
Gs^Fds, Mm, Gs^Fds, Hh^Fds, Hh^Fds, Hh^Fds, Hh^Fds, Gg, Gg, Gs, Re, Gs, Wwt, Wwt, Wwt, Wwt, Wwt, Gg^Es, Wwt^Bw\, Wwt, Wwt, Wwt, Gs^Fds, Gs^Fds, Gs^Fds, Mm, Mm, Mm, Mm, Mm
Gs^Fds, Gs^Fds, Mm, Hh^Fds, Hh^Fds, Hh^Fds, Gg, Gg, Gg, Gg, Gg^Es, Wwt^Bw\, Gg^Es, Wwt, Gg^Efm, Wwt, Wwt, Wwt, Wwt, Gg^Es, Gg, Gg, Gg^Vws, Gs^Fds, Gs^Fds, Mm, Mm, Mm, Mm, Mm
Mm, Mm, Mm, Mm, Mm, Gg, Gg, Gg, Wwt, Wwt, Wwt, Wwt, Re^Gvs, Re^Gvs, Gg^Vws, Gg^Efm, Wwt, Wwt, Gg^Efm, Gg, Gs, Gg, Gs, Gs^Fds, Gs^Fds, Gs^Fds, Mm, Mm, Mm, Mm
Mm, Mm, Mm, Mm, Mm, Gg, Mm, Gg, Wwt, Wwt, Gg^Vws, Wwt, Gg^Es, Re^Gvs, Gs^Wm, Gg, Wwt, Gg^Efm, Gg, Gg, Gg, Gs, Gs, Gg, Gg, Gs^Fds, Gs^Fds, Mm, Hh^Fds, Mm
Mm, Mm, Mm, Mm, Mm, Mm, Wwt, Wwt, Mm, Gs^Fds, Gs^Fds, Wwt, Wwt^Bw/, Gg, Gg, Gg, Wwt, Hh^Vws, Hh, Hh, Hh, Gs, Gs, Gg, Gg, Gs^Fds, Hh^Fds, Hh^Fds, Hh^Fds, Hh^Fds
Hh^Fds, Mm, Mm, Mm, Mm, Wwt, Mm, Wwt, Mm, Gs^Fds, Gg, Gg, Wwt, Gs^Fds, Hh, Hh, Wwt, Mm, Mm^Xm, Mm, Mm, Gs^Fds, Gs^Fds, Gg, Gg^Es, Gg, Hh^Fds, Hh^Fds, Hh^Fds, Hh^Fds
Hh^Fds, Hh^Fds, Hh^Fds, Mm, Mm, Mm, Mm, Mm, Mm, Gg^Efm, Gg^Efm, Wwt, Gs^Fds, Gs^Fds, Hh, Mm, Mm, Wwt, Mm^Xm, Mm, Mm, Gs^Fds, Gs^Fds, Gg, Gg, Gg, Gg, Hh^Fds, Hh^Fds, Hh^Fds
Hh^Fds, Hh^Fds, Hh^Fds, Mm, Mm, Mm, Mm, Mm, Gg, Gg^Efm, Gg^Es, Wwt, Wwt, Gs^Fds, Hh, Mm, Mm, Mm^Xm, Mm, Mm, Gs^Fds, Gs^Fds, Gg, Gg, Gg^Vws, Gg, Gg, Hh^Fds, Hh^Fds, Hh^Fds
Hh^Fds, Hh^Fds, Hh^Fds, Mm, Mm, Mm, Mm, Mm, Gg, Gg^Vws, Gg, Wwt, Gs^Fds, Gs^Fds, Gs^Fds, Hh, Mm, Mm, Mm, Mm, Gs^Fds, Gs^Fds, Gg, Gs, Gg, Gg, Gg, Gg, Mm, Hh^Fds
Hh^Fds, Hh^Fds, Hh^Fds, Hh^Fds, Gs^Fds, Gs^Fds, Gg, Gg, Gg, Gs, Gg, Wwt, Gs^Fds, Gs^Fds, Gs^Fds, Mm, Mm, Mm, Mm, Mm, Gs^Fds, Gg, Gg, Gs, Gg^Efm, Gg, Mm, Mm, Mm, Mm
Hh^Fds, Hh^Fds, Hh^Fds, Hh^Fds, Gs^Fds, Gs^Fds, Gg, Gg^Efm, Wwt, Wwt, Wwt, Wwt, Wwt, Gs^Fds, Gs^Fds, Mm, Mm, Mm, Gs^Fds, Gs^Fds, Gs^Fds, Gg, Gg, Gg^Efm, Gg, Gg, Mm, Mm, Mm, Mm
Hh^Fds, Hh^Fds, Hh^Fds, Hh^Fds, Hh^Fds, Gs^Fds, Gs^Fds, Gg, Wwt, Ww^Ewf, Ww^Vm, Ww^Ewf, Wwt, Wwt, Gg, Gs^Fds, Gs^Fds, Gs^Fds, Gs^Fds, Gg, Gg, Gg, Gg, Gs, Gg, Gg, Mm, Mm, Mm, Mm
Mm, Hh^Fds, Hh^Fds, Hh^Fds, Hh^Vws, Hh^Fds, Gg, Gg, Wwt, Ww^Ewf, Ww^Ewf, Wwt, Ww^Ewf, Wwt, Gg, Gs^Fds, Gs^Fds, Gs^Fds, Gg, Gg, Gg, Gg, Gg, Gg^Vws, Gg, Mm, Mm, Mm, Mm, Mm
Mm, Mm, Mm, Hh^Fds, Hh^Fds, Hh^Fds, Gs^Fds, Gg, Gg, Wwt, Wwt, Wwt, Wwt, Wwt, Gg^Eff, Gg^Eff, Gs^Fds, Gg^Vws, Gg, Gs, Gg, Gg, Gg, Gs^Fds, Gs^Fds, Mm, Mm, Mm, Mm, Mm
Mm, Mm, Mm, Hh^Fds, Hh^Fds, Gs^Fds, Gs^Fds, Gs^Fds, Gs^Fds, Gg, Gg, Gg, Gg^Eff, Gg^Eff, Re^Gvs, Re^Gvs, Gs^Wm, Gg^Eff, Gg^Eff, Gs^Es, Gg, Gg^Es, Gg, Gs^Fds, Gs^Fds, Mm, Mm, Mm, Mm, Mm
Mm, Mm^Xm, Mm, Mm, Mm, Gs^Fds, Gs^Fds, Gs^Fds, Gll^Cov, Gs^Fds, Gs^Fds, Gg, Gs^Fds, Gs^Eff, Gs^Eff, Re^Gvs, Gs^Eff, Gs^Eff, 1 Gs, Gs, Cw, Cw, Cw, Gs^Fds, Mm, Mm, Mm, Mm, Mm, Mm
Mm, Mm^Xm, Mm^Xm, Mm, Mm, Mm, Gs^Fds, Gll^Cov, Gs^Kov, Gll^Cov, Gs^Fds, Gg, Gs^Fds, Gg^Vws, Gs^Fds, Gs^Eff, Gs^Fds, Gg, Gs^Fds, Gs, Cw, 2 Kw, Cw, Mm, Mm, Mm, Mm, Mm, Mm, Mm
Mm, Mm^Xm, Mm^Xm, Mm, Mm, Mm, Gs^Fds, Gll^Cov, Gll^Cov, Gll^Cov, Gs^Fds, Gs^Fds, Gs^Fds, Gs^Fds, Mm, Gs^Fds, Gs^Fds, Gs^Fds, Gs^Fds, Gs^Fds, Gs^Fds, Cw, Mm, Mm, Mm, Mm, Mm, Mm, Mm, Mm
Mm, Mm, Mm^Xm, Mm, Mm, Mm, Mm, Gs^Fds, Gs^Fds, Gs^Fds, Mm, Gs^Fds, Mm, Mm, Mm, Mm, Mm, Mm, Mm, Gs^Fds, Mm, Mm, Mm, Mm, Mm, Mm, Mm, Mm, Mm^Xm, Mm
Mm, Mm, Mm^Xm, Mm^Xm, Mm^Xm, Mm, Mm, Mm, Mm, Mm, Mm, Mm, Mm, Mm, Mm, Mm^Xm, Mm^Xm, Mm, Mm, Mm, Mm, Mm, Mm, Mm, Mm, Mm, Mm, Mm, Mm^Xm, Mm
Mm, Mm, Mm, Mm^Xm, Mm^Xm, Mm, Mm, Mm, Mm^Xm, Mm, Mm, Mm, Mm, Mm, Mm^Xm, Mm^Xm, Mm^Xm, Mm, Mm, Mm, Mm, Mm, Mm, Mm^Xm, Mm^Xm, Mm, Mm, Mm^Xm, Mm^Xm, Mm
Mm, Mm, Mm, Mm, Mm, Mm, Mm, Mm, Mm, Mm, Mm, Mm, Mm, Mm, Mm, Mm^Xm, Mm, Mm, Mm, Mm, Mm, Mm, Mm, Mm, Mm, Mm^Xm, Mm^Xm, Mm^Xm, Mm, Mm
Mm, Mm, Mm, Mm, Mm, Mm, Mm, Mm, Mm, Mm, Mm, Mm, Mm, Mm, Mm, Mm, Mm, Mm, Mm, Mm, Gg, Mm, Mm, Mm, Mm, Mm, Mm, Mm, Mm, Mm
