Mm, Mm, Mm, Mm, Mm, Mm, Mm, Hh^Fds, Hh^Fds, Gg, Hh^Fds, Ww, Ww, Hh^Fds, Hh^Fds, Ww, Ww, Gs^Fds, Hh^Fds, Hh^Fds, Hh^Fms, Hh^Fms, Mm, Mm, Mm, Mm, Mm, Mm^Xm, Mm^Xm, Mm^Xm, Mm^Xm, Mm^Xm, Mm^Xm, Mm^Xm
Mm, Mm, Mm, Mm, Mm, Mm, Mm, Mm, Mm, Hh^Fds, Hh^Fds, Ww, Ww, Hh^Fds, Hh^Fds, Hh^Fds, Ww, Hh^Fds, Hh^Fds, Hh^Fds, Hh^Fds, Hh^Fms, Hh^Fms, Mm, Mm, Mm, Mm, Mm^Xm, Mm^Xm, Mm^Xm, Mm^Xm, Mm^Xm, Mm^Xm, Mm^Xm
Mm, Mm, Mm, Mm, Ce, Ce, Ce, Mm, Mm, Hh^Fds, Hh, Hh^Fds, Gs^Fds, Ww, Ww, Hh^Fds, Ww, Hh^Fds, Hh^Fds, Hh^Fds, Hh^Fds, Hh^Fds, Hh^Fms, Mm, Mm, Mm, Mm, Mm, Mm, Mm^Xm, Mm, Mm^Xm, Mm^Xm, Mm^Xm
Mm^Xm, Mm, Mm, Mm, Ce, 4 Ke, Ce, Mm, Hh^Vhh, Hh^Fds, Hh, Gs^Fds, Gg, Gs^Fds, Hh^Vhh, Ww, Hh^Fds, Hh^Fds, Gs^Fds, Hh^Fds, Gs^Fds, Hh^Fms, Mm, Mm, Mm, Mm, Mm, Mm, Mm, Mm, Mm, Mm^Xm, Mm^Xm, Mm^Xm
Mm^Xm, Mm^Xm, Mm, Mm, Mm, Ce, Mm, Hh^Fds, Hh, Hh^Fds, Gg, Gg, Gg, Gs^Fds, Gs^Fds, Ww, Ww, Gs^Fds, Gs^Fds, Gs^Fds, Hh^Fms, Hh^Fms, Mm, Mm, Mm, Mm, Mm, Mm, Ww, Mm, Mm, Mm, Mm, Mm^Xm
Mm^Xm, Mm^Xm, Mm, Mm, Mm, Mm, Hh^Fds, Hh, Gg, Gg, Gs^Es, Gs, Gg, Gg, Gg, Gs^Fds, Ww, Hh^Fms, Mm, Mm^Xm, Mm, Hh^Fms, Hh^Fms, Mm, Hh^Vhh, Mm, Mm, Gs^Fds, Ww, Mm, Mm, Mm, Mm, Mm
Mm^Xm, Mm^Xm, Mm, Hh^Fds, Hh^Fds, Hh^Vhh, Hh^Fds, Gg, Gs^Es, Gg, Hh^Vhh, Gg, Mm, Hh^Fms, Hh^Fms, Gg, Ww, Hh^Fms, Mm, Mm, Mm, Mm, Hh^Fms, Gs^Fds, Mm, Mm, Mm, Mm, Ww, Mm, Mm, Mm, Mm, Mm
Mm^Xm, Mm^Xm, Mm, Hh^Fds, Hh^Fds, Hh, Gg, Gs, Gs, Gs, Mm, Mm^Xm, Mm, Mm, Mm, Hh^Fms, Ww, Ww, Mm, Mm, Mm, Mm, Hh^Fms, Gs^Fds, Gs^Fds, Mm, Mm, Mm, Mm, Ww, Ww, Mm, Mm, Mm
Mm, Mm, Mm, Mm, Mm, Hh, Gg, Gs, Gg, Mm, Mm, Mm, Hh^Fds, Hh^Fds, Gg, Ww, Ww, Hh^Fms, Hh^Fms, Hh^Fms, Hh^Fms, Hh^Fms, Gg, Gs^Fds, Ww, Mm, Mm, Mm, Mm, Ww, Ww, Mm, Mm, Mm
Mm, Mm, Mm, Mm, Mm, Gg, Gg, Gg, Hh^Vhh, Gg, Gg, Mm, Gg, Gg, Gg^Es, Ww, Ww, Gs^Vc, Ww, Ww, Ww, Ww, Ww, Ww, Hh^Fms, Ww, Ww, Mm, Ww, Ww, Gs^Fds, Ww, Ww, Ww
Mm, Mm, Mm^Xm, Mm, Mm, Mm, Mm, Mm, Mm, Mm^Xm, Mm^Xm, Gg, Gg, Gs, Gs^Es, Gg, Ww, Ww, Hh^Fms, Gg, Gs, Gg, Hh^Fms, Hh^Fms, Mm, Mm, Mm, Ww, Hh^Fms, Gs^Fds, Hh^Fms, Hh^Fms, Mm, Ww
Mm, Mm^Xm, Mm^Xm, Mm^Xm, Mm, Mm, Mm^Xm, Mm, Mm, Mm, Mm, Mm^Xm, Cud, Gg, Gg, Gg, Ww, Ww, Mm, Hh^Fms, Gg, Gs, Hh, Mm, Mm, Mm, Mm, Mm, Mm, Hh^Fms, Mm, Mm, Mm, Mm
Mm, Mm^Xm, Mm^Xm, Mm^Xm, Mm^Xm, Mm^Xm, Mm^Xm, Mm^Xm, Mm, Mm, Cud, Mm, Mm, Hh^Fds, Hh^Fds, Gg, Ww, Ww, Mm, Hh, Gg, Gg, Gg, Hh, Mm, Mm, Mm, Mm, Hh^Vhh, Mm, Mm, Mm, Mm, Mm
Mm^Xm, Mm^Xm, Mm^Xm, Mm^Xm, Mm^Xm, Mm^Xm, Mm^Xm, Mm^Xm, Xu, Xu, Cud, Cud, Mm, Hh^Vhh, Hh^Fds, Gg, Ww, Hh^Fms, Mm, Hh, Gg, Gg, Gg, Hh, Hh^Fms, Mm, Mm, Mm, Mm, Mm, Mm, Mm, Mm, Mm
Mm^Xm, Mm^Xm, Mm^Xm, Mm^Xm, Mm^Xm, Mm, Mm, Mm, Xu, Uu, 3 Kud, Cud, Mm, Mm, Hh^Fds, Gg, Ww, Hh, Mm, Hh^Fms, Hh, Gg, Gg, Gg, Hh^Vhh, Mm, Mm, Cud, Cud, Xu, Xu, Mm, Mm^Xm, Mm
Mm, Mm^Xm, Mm^Xm, Mm^Xm, Mm^Xm, Mm, Mm, Mm, Mm, Xu, Cud, Cud, Mm, Mm, Hh^Fms, Gg, Gg, Ww, Hh^Fms, Mm, Hh, Gg^Es, Gs, Gg, Hh^Fms, Mm, Mm, Cud, 2 Kud, Uu, Xu, Mm^Xm, Mm^Xm, Mm^Xm
Mm, Mm, Mm, Mm^Xm, Mm, Mm, Mm, Mm, Mm, Mm, Mm, Mm, Cud, Hh^Fms, Gs, Gg, Ww, Ww, Mm, Mm, Hh^Fms, Gg, Gg, Gg, Hh, Mm, Mm, Cud, Cud, Xu, Mm, Mm^Xm, Mm^Xm, Mm^Xm
Mm, Mm, Mm, Mm, Mm, Mm, Hh^Fds, Mm, Hh^Vhh, Mm, Mm, Mm, Hh^Vhh, Hh^Fds, Gs, Gg, Ww, Hh, Mm, Hh^Fms, Gg, Gs^Es, Gs, Hh^Fms, Mm, Mm, Mm, Mm, Mm, Mm, Mm, Mm^Xm, Mm^Xm, Mm^Xm
Mm, Mm, Mm, Mm, Mm, Mm, Hh^Fds, Hh^Fds, Hh^Fds, Hh^Fds, Hh^Fds, Hh^Fds, Hh^Fds, Hh^Fds, Gg, Gg, Ww, Hh^Fms, Mm, Hh, Gg, Gg, Gg, Hh^Fms, Hh, Mm, Mm, Mm, Mm, Mm, Mm, Mm^Xm, Mm^Xm, Mm^Xm
Mm, Mm, Mm, Mm, Hh^Fds, Hh^Fds, Gs^Es, Gs, Gg, Gs, Gg^Es, Gg, Gg, Gg, Hh^Fms, Hh^Fms, Ww, Hh^Fms, Hh^Fms, Hh^Fms, Ww, Ww, Ww, Gg, Gg, Hh, Mm, Hh^Vhh, Mm, Mm, Mm, Mm, Mm, Mm
Mm, Mm, Mm, Mm, Gs, Gs, Gg, Gg, Hh^Fds, Gs, Gg, Gg, Gg, Hh^Fms, Mm, Hh^Fms, Ww, Gg, Gg, Gg, Ww, Ww, Ww, Ww, Ww, Hh^Fms, Hh^Fds, Mm, Mm, Mm, Mm, Mm, Mm, Mm
Mm, Mm, Hh^Fds, Mm, Gg, Gs^Vc, Hh^Fds, Hh^Fds, Mm, Hh^Fds, Hh^Fds, Gg, Gg, Hh^Fms, Hh^Fms, Hh^Fms, Ww, Gg, Ww, Ww, Ww, Ww^Vm, Ww, Ww, Gs, Gg, Gg, Hh^Fds, Hh^Fds, Mm, Mm, Mm, Mm^Xm, Mm^Xm
Mm, Mm, Gs, Gs, Hh^Fds, Hh^Fds, Mm, Mm, Mm, Mm, Hh^Fds, Hh^Fds, Gg, Gg, Gg, Ww, Gg, Ww, Gg, Gg, Gg, Ww, Gg, Gg, Gg, Gs, Hh^Fds, Hh^Fds, Mm, Mm, Mm, Mm^Xm, Mm^Xm, Mm^Xm
Gs^Fds, Gs^Fds, Gs^Fds, Gs, Hh^Fds, Mm, Mm, Mm, Hh^Vhh, Mm, Mm, Hh^Fds, Gg, Gg, Ww, Ww, Gs^Es, Gg^Es, Gg, Gg, Mm, Gg, Mm, Mm, Mm, Gg, Hh^Fds, Mm, Mm, Mm, Mm, Mm^Xm, Mm^Xm, Mm^Xm
Gs^Fds, Gs^Fds, Gs^Fds, Hh^Fds, Gs^Fds, Mm, Mm, Mm, Mm, Mm, Mm, Hh^Fds, Gs, Gg, Gs^Vht, Ww, Gg, Gs, Mm, Mm, Mm, Mm, Mm, Mm, Mm, Mm, Hh^Vhh, Mm, Mm, Mm, Mm, Mm, Mm, Mm
Gs^Fds, Gs^Fds, Gs^Fds, Gs^Fds, Hh^Fds, Mm, Mm, Mm, Mm, Mm, Hh^Fds, Hh^Fds, Gs, Gg, Ww, Ww, Gg, Gg, Mm, Mm, Mm, Mm, Mm, Mm, Mm, Mm, Mm, Mm, Mm, Mm, Mm, Mm, Mm, Mm
Gs^Fds, Gs^Fds, Gs^Fds, Gs^Fds, Gs^Fds, Hh^Fds, Hh^Fds, Mm, Hh^Fds, Hh^Fds, Gs^Cov, Gs, Gg, Gg, Ww, Ww, Ww, Gg, Mm, Mm, Mm, Mm, Mm, Mm, Mm, Mm, Mm, Mm, Mm, Mm, Mm, Mm, Mm, Mm
Gs^Fds, Gs^Fds, Gs^Fds, Gs^Fds, Gs^Fds, Gs^Fds, Gs^Fds, Hh^Fds, Gs^Fds, Gs^Cov, 1 Gg^Kov, Gg^Cov, Ww, Ww, Gg, Ww, Ww, Gg, Mm, Mm, Mm, Mm, Mm, Mm, Mm, Mm, Mm, Mm, Mm, Mm, Mm, Mm, Mm^Xm, Mm
Gs^Fds, Gs^Fds, Mm, Gs^Fds, Gs^Fds, Gs^Fds, Mm^Xm, Gs^Fds, Gs^Fds, Gs^Cov, Gs^Cov, Gg^Cov, Ww, Gg, Gg, Gg, Gg, Ww, Ww, Mm, Mm, Mm, Mm, Mm, Mm, Mm, Mm, Mm, Mm, Mm, Mm, Mm^Xm, Mm^Xm, Mm^Xm
Mm, Mm, Mm, Mm^Xm, Mm^Xm, Mm, Mm, Mm, Mm, Gs^Fds, Ww, Ww, Gg, Gg, Mm, Mm, Mm, Gg, Hh^Fds, Ww, Ww, Hh^Fds, Hh^Fds, Mm, Mm, Mm, Mm, Mm, Mm, Mm, Mm, Mm^Xm, Mm^Xm, Mm^Xm
Mm, Mm, Mm, Mm, Mm, Mm^Xm, Mm, Mm, Mm, Mm, Ww, Gg, Mm, Mm, Mm, Mm, Mm, Mm, Mm, Hh^Fds, Hh^Fds, Ww, Hh^Fds, Mm, Mm, Mm, Mm, Mm, Mm, Mm, Mm, Mm, Mm^Xm, Mm^Xm
Mm, Mm, Mm, Mm, Mm, Mm, Mm, Mm, Mm, Mm, Ww, Gg, Mm, Mm, Mm, Mm, Mm, Mm, Mm, Mm, Hh^Fds, Ww, Ww, Hh^Fds, Hh^Fds, Mm, Hh^Fds, Mm, Mm, Mm, Mm, Mm, Mm^Xm, Mm^Xm
Mm, Mm, Mm, Mm, Mm, Mm, Mm, Mm, Mm, Mm, Ww, Ww, Mm, Mm, Mm, Mm, Mm^Xm, Mm^Xm, Mm^Xm, Mm, Mm, Hh^Fds, Hh^Fds, Ww, Ww, Hh^Fds, Hh^Fds, Mm, Mm, Mm, Mm, Mm^Xm, Mm^Xm, Mm^Xm
Mm, Mm, Mm, Mm, Mm, Mm, Mm, Mm, Hh^Fds, Hh^Fds, Ww, Ww, Mm, Mm, Mm, Mm^Xm, Mm^Xm, Mm^Xm, Mm^Xm, Mm, Mm, Mm, Mm, Hh^Fds, Hh^Fds, Ww, Hh^Fds, Mm, Mm, Mm, Mm^Xm, Mm^Xm, Mm^Xm, Mm^Xm
Mm, Mm, Mm, Mm, Mm, Mm, Mm, Hh^Fds, Ww, Ww, Hh^Fds, Mm, Mm, Mm, Mm^Xm, Mm^Xm, Mm^Xm, Mm^Xm, Mm, Mm, Mm, Mm, Mm, Mm, Ww, Ww, Mm, Mm, Mm, Mm, Mm^Xm, Mm^Xm, Mm^Xm, Mm^Xm
Mm, Mm, Mm, Mm, Mm, Mm, Mm, Hh^Fds, Ww, Ww, Hh^Fds, Mm, Mm, Mm, Mm^Xm, Mm^Xm, Mm^Xm, Mm^Xm, Mm^Xm, Mm, Mm, Mm, Mm, Mm, Ww, Ww, Mm, Mm, Mm, Mm, Mm^Xm, Mm^Xm, Mm^Xm, Mm^Xm
Mm, Mm, Mm, Mm, Mm, Mm, Mm, Hh^Fds, Ww, Ww, Gg, Mm, Mm, Mm, Mm^Xm, Mm^Xm, Mm^Xm, Mm^Xm, Mm^Xm, Mm, Mm, Mm, Mm, Mm, Hh^Fds, Ww, Gg, Mm, Mm, Mm, Mm^Xm, Mm^Xm, Mm^Xm, Mm^Xm
