Mm, Mm, Mm, Mm, Mm, Mm, Mm, Mm, Mm, Mm, Mm, Gs, Hh, Mm, Mm, Mm, Mm, Mm, Mm, Mm, Mm, Mm, Hhd, Gd^Fetd, Gd^Fetd, Gd^Fetd, Gd^Fetd, Gd^Fetd, Hhd, Gg, Mm, Gg, Ww, Ww, Mm, Mm, Mm, Mm, Mm, Mm
Mm, Mm, Mm, Mm^Xm, Mm, Mm, Mm^Xm, Mm^Xm, Mm, Mm, Hh, Gs, Hh, Mm, Mm, Mm, Mm, Mm, Mm, Mm, Mm, Mm, Hhd, Gd^Fetd, Gd^Fetd, Gd^Fetd, Gd^Fetd, Gd^Fetd, Hhd, Mm, Mm^Xm, Mm, Ww, Ww, Mm, Mm, Mm, Mm, Mm, Mm
Mm, Mm, Mm, Mm, Mm, Mm, Mm, Mm, Hh, Hh, Hh, Gs, Gs, Hh, Hh, Mm, Mm, Mm, Hhd, Hhd, Hhd, Hh, Gd, Gd^Fetd, Gd, Gd, Gd^Fetd, Gd^Fetd, Hhd, Mm, Mm, Mm^Xm, Mm^Xm, Ww, Ww, Mm, Mm, Mm, Mm^Xm, Mm
Mm, Mm, Mm, Mm, Mm, Mm, Hh^Fds, Hh, Gd^Fetd, Gd^Fetd, Gs, Gs, Gs, Gs, Gs, Hh, Hh, Hh, Gs, Gd^Fetd, Gs, Gs, Gs, Gd, Gd, Gd, Gd, Gd^Fetd, Hhd, Mm, Mm, Mm, Mm, Mm, Ww, Ww, Gs^Fds, Mm, Mm, Mm
Mm, Mm, Mm, Mm, Mm, Hh^Fds, Hh^Fds, Hh, Gd, Gs, Gd^Dr, Gs, Gd, Gs, Gs, Gs, Gs, Gs, Gs, Gd, Gd, Gd, Gs, Gd, Gd, Gd, Gs, Gd, Gd^Vwsr, Hhd, Hh, Mm, Mm, Mm, Ww, Ww, Mm, Mm, Mm, Mm
Mm, Mm, Mm, Mm, Hh^Fds, Hh, Hh^Vwsr, Gs, Gd, Gd, Gs, Gs, Gd, Gs, Gd, Gs, Gs, Gd^Dr, Gs, Gs, Gd, Gs^Es, Gs, Gs, Gs, Gd, Gd, Gs, Gg, Gd, Gd, Hh, Hh, Ww, Ww, Mm, Mm, Mm, Mm, Mm
Mm, Mm, Hh^Fds, Hh^Fds, Hh, Gs, Gs, Gs, Gd, Gd, Gs, Gs, Gs, Gd, Gs, Gs, Hh, Gs, Hh, Gs, Gd, Gs, Gs, Gs, Gd, Gd, Hh, Hh, Gd^Fetd, Gd, Gd, Gs, Ww, Ww, Gs^Fds, Mm, Mm, Mm, Mm, Mm
Hh^Fds, Hh^Fds, Hh^Fds, Hh, Gd^Dr, Gs, Gd^Fetd, Gd^Fetd, Gs, Gs, Hh, Gs, Gs, Gs, Gs, Hh, Hh, Hh, Hh, Gs, Gs, Gd, Gd, Gs, Gs, Gs, Hh, Hh^Vwsr, Hh, Gd^Fetd, Gd, Gs, Ww, Ww, Gs^Fds, Mm, Mm, Mm, Gs^Fds, Gs^Fds
Hh^Fds, Hh^Fds, Hh, Gs, Gs, Gs, Gs, Gs, Hh, Hh, Hh, Hh, Gs, Gs, Gs, Hh, Gd^Fetd, Hh, Hh, Gs, Gd, Gd, Gd^Fetd, Gd, Gd, Gd^Vwsr, Gd^Fetd, Hh, Gd^Fetd, Hh, Gs, Ww, Gg, Gg, Gg, Gs^Fds, Gs^Fds, Gs^Fds, Gs^Fds, Gs^Fds
Ww, Hh, Ww, Ww, Ww, Gs, Gs, Hh, Hh, Hh, Gs, Gs, Gs, Gd^Fetd, Gd^Fetd, Gs, Gs, Gs, Hh, Gs, Gd, Gd^Fetd, Gd^Fetd, Gd^Fetd, Gd^Fetd, Gd, Gs, Gd^Fetd, Gd, Gd, Gs, Ww, Gg, Gd^Fetd, Gd^Fetd, Gd^Fetd, Gs^Fds, Gg, Gg, Gs^Fds
Gs^Fds, Ww, Gs^Fds, Gs^Fds, Gs^Fds, Ww, Ww, Hh, Hh, Hh, Gd, Gs^Dr, Gs, Gs, Gd, Gd, Gs, Gs, Gs, Gs, Gs, Gd^Fetd, Gd, Gd^Fetd, Gs, Gs, Gs, Gd, Gs, Rp, Ww, Ww^Bw\r, Rp, Gg, Gs, Gd^Fetd, Gs^Fds, Gg, Gg, Gg
Gs^Fds, Gs^Fds, Gs^Fds, Gs^Fds, Gg, Gg, Ww, Gs, Gs, Gs, Gd, Gs, Gs, Gd, Gs^Dr, Gg, Gs, Gs, Gs, Gs, Kwr, Gd, Rp, Gs, Kwr, Rp, Gs, Rp, Ww, Ww, Ww, Gg, Gs, Gs, Gd^Fetd, Gg, Gs^Fds, Gs, Gs, Gg
Mm, Gs^Fds, Gs^Fds, Gs^Fds, Gg, Gg, Ww, Ww, Gs, Gd, Gs, Gs, Gd^Fetd, Gd, Gd, Gs, Gs, Gs, Gs, Cwr, Gd^Fetd, Cwr, Gg^Bsb|, Cwr, Gd^Fetd, Cwr, Ww, Ww, Wo, Wo, Ww, Gg, Gs, Gd^Fetd, Gd^Fetd, Gd^Vwsr, Gs^Fds, Gg, Gs, Gg
Mm, Mm, Mm, Gs^Fds, Gs^Fds, Gg, Gg, Ww, Ww, Ww, Ww, Gs, Gd, Gd^Fetd, Gs, Gs, Ww, Ww, Ww, Ww, Ww, Gd^Fetd, Ww^Bsb|, Gd^Fetd, Ww, Ww, Mm, Ww, Wo, Wo, Ww, Gg, Rp, Gs, Gs, Gd^Fetd, Gg, Gs, Rp, Gg
Mm, Mm^Xm, Mm, Gs^Fds, Gs^Fds, Gs^Fds, Gg, Gg, Gs, Gs, Ww, Gs, Ww, Gs, Gs, Gs, Ww, Ww, Mm^Xm, Kwr, Ww, Ww, Rr, Ww, Ww, Kwr, Mm, Ww, Ww, Wo, Ww, Gg, Gs, Gs, Rp, Gg, Rp, Rp, Gg, Rp
Mm, Mm, Mm, Mm, Mm, Gs^Fds, Gs^Fds, Gs, Gs, Gs, Gg, Ww, Gs, Ww, Ww, Ww, Ww, Mm^Xm, Mm, Mm^Xm, Mm, Cwr, Rp^Dr, Cwr, Mm, Mm, Mm, Mm, Mm, Ww, Ww, Gg, Gs, Rp, Gg, Rp, Hh^Fds, Hh^Fds, Hh^Fds, Gg
Mm, Mm, Mm, Mm^Xm, Mm^Xm, Gs^Fds, Gg, Gs, Gg, Gs, Gs, Gs, Gg, Ww, Ww, Ww, Mm^Xm, Mm, Cwr, Cwr, Rr, Rr, Rr, Rr, Rp^Vwsr, Cwr, Cwr, Mm, Mm^Xm, Ww, Ww, Gg, Gg, Gs, Gs, Hh^Fds, Mm, Mm^Xm, Mm, Hh^Fds
Mm, Mm^Xm, Mm^Xm, Mm, Mm, Mm, Gd, Gd, Gd, Gd^Vwsr, Gs, Gs, Gd^Dr, Gs, Ww, Ww, Ww, 4 Kwr, Cwr, Rr^Dr, Rr, Rp^Vwsr, Cwr, Rr^Dr, Rr, Rr, Cwr, 5 Kwr, Mm, Mm^Xm, Ww, Ww, Gs, Gs, Gg, Hh^Fds, Mm, Mm, Mm, Mm
Mm, Mm, Mm, Mm^Xm, Mm, Mm, Gd^Fetd, Gd^Fetd, Gd^Fetd, Gd, Gs, Gs, Gs, Gg, Ww, Wo, Ww, Cwr, Rp^Vwsr, Cwr, Kwr, Cwr, Cwr, Cwr, Kwr, Cwr, Rr^Dr, Cwr, Mm, Mm^Xm, Ww, Ww, Gs, Gs, Gg, Hh^Fds, Hh^Fds, Mm, Mm, Mm
Mm, Mm, Mm, Mm, Mm, Mm, Gs^Fds, Gd^Fetd, Gd, Gd, Gs, Gs, Gs, Gg, Ww, Ww, Mm, Cwr, Rr^Dr, Rp^Vwsr, Cwr, Cwr, 3 Kwr, Cwr, Cwr, Rp^Vwsr, Rp^Dr, Cwr, Mm, Mm, Ww, Ww, Gg, Gs, Gg, Hh^Fds, Hh^Fds, Mm, Mm, Mm
Mm, Mm, Mm, Mm, Mm, Gs^Fds, Gs^Fds, Gd^Fetd, Gd, Gd, Ww, Gg, Ww, Ww, Ww, Mm^Xm, Mm, Cwr, Rp^Vwsr, Rp^Vwsr, Kwr, Cwr, Cwr, Cwr, Kwr, Rr^Dr, Rp^Vwsr, Cwr, Mm, Mm, Ww, Ww, Gg, Gs, Gg, Gg, Hh^Vwsr, Hh^Fds, Mm, Mm
Mm, Mm, Mm^Xm, Mm^Xm, Mm, Gs^Fds, Ww, Ww, Ww, Gg, Ww, Ww, Mm^Xm, Ww, Mm, Mm, Mm, Cwr, Cwr, Cwr, Rr, Cwr, Cwr, Cwr, Rr, Cwr, Cwr, Cwr, Mm, Mm, Ww, Ww, Gg, Gg, Gs, Gg, Gg, Hh^Fds, Hh^Fds, Mm
Mm, Mm^Xm, Mm, Mm, Ww, Ww, Ww, Gs, Gs, Ww, Ww, Cwr, Mm, Mm^Xm, Mm^Xm, Mm, Cwr, Kwr, Cwr, Rp^Vwsr, Rr, Rp^Vwsr, Rr^Dr, Rp^Vwsr, Rr, Rp^Vwsr, Cwr, Kwr, Mm^Xm, Mm, Ww, Ww, Ww, Gg, Gg, Gg, Gg, Gg, Gg, Hh^Fds
Mm, Mm, Mm, Ww, Ww, Ww, Mm^Xm, Gs^Fds, Gd, Ww, Ww, Kwr, Cwr, Mm, Cwr, Cwr, Ww, Mm, Mm, Cwr, Mm, Rr, Rr, Rr, Mm, Cwr, Mm, Mm, Mm, Ww, Ww, Wo, Wo, Ww, Ww, Ww, Ww, Gg, Gg, Gg
Ww, Mm, Ww, Ww, Mm, Mm, Mm, Mm, Gd^Fetd, Gd, Gd, Ww, Ww, Kwr, Ww, Ww, Ww, Ww, Ww, Mm, Mm, Cwr, Rr, Cwr, Mm, Mm, Mm, Mm, Ww, Ww, Gd, Ww, Ww, Wo, Ww, Ww, Ww, Ww, Ww, Gg
Ww, Ww, Ww, Mm, Mm, Mm, Mm^Xm, Mm, Gs^Fds, Gd^Fetd, Gd^Fetd, Gd, Ww, Ww, Ds, Ds, Ds, Ww, Ww, Kwr, Ww, Ww, Ww, Ww, Ww, Kwr, Ww, Ww, Gg, Gs, Gs, Gd, Gg, Ww, Gs, Gs, Gg, Ww, Ww, Ww
Mm, Mm, Mm, Mm, Mm, Mm, Mm, Mm, Gs^Fds, Gs^Fds, Gd, Gd, Ww, Ds, Gd^Fetd, Gd^Fetd, Ds, Ww, Gs, Ww, Gd, Ww, Gg^Bsb|, Ww, Ww, Ww, Gg, Gd, Gd, Gd, Gs, Gs, Gs, Gs, Gs, Gs, Gg, Gg, Gg, Ww
Mm, Mm, Mm, Mm, Mm, Mm, Mm, Mm, Gs^Fds, Gd^Fetd, Gs, Ww, Ds, Ds, Gd^Vwsr, Ds, Ww, Ww, Gg, Kwr, Cwr, Gs, Rp, Gd, Cwr, Kwr, Gg, Gd, Gs, Gs, Gs, Gs, Gs, Gs, Gs, Gd^Vwsr, Gg, Gg, Rp, Gg
Mm, Mm, Mm, Mm, Mm, Mm, Mm, Mm, Mm, Gs^Fds, Gg, Ww, Ds, Gd^Fetd, Gd^Fetd, Ds, Ww, Ww, Gd, Gd, Gd, Kwr, Rp, Kwr, Gg, Rp, Gs, Gs, Gs, Gs, Gs, Gs, Rp, Rp, Rp, Gs, Rp, Rp, Gg, Rp
Gs^Fds, Gs^Fds, Mm, Mm, Mm, Mm, Mm, Mm, Mm, Mm, Gs, Ww, Ww, Ds, Ds, Ds, Ww, Gg, Gs, Gs, Rp, Rp, Hh, Hh, Hh, Hh^Fds, Hh^Fds, Gs, Rp, Rp, Gs, Gs, Gs, Gg, Mm, Rp, Gg, Gg, Gg, Gg
Gs^Fds, Gs^Fds, Gs^Fds, Mm, Mm, Mm, Mm, Mm, Mm, Mm, Gg, Ww, Ww, Ww, Ww, Ww, Ww, Gs, Gg, Gg^Es, Rp, Gg, Gg, Hh, Hh, Hh, Hh^Fds, Hh^Fds, Gg, Gd^Vwsr, Gg, Gg, Mm, Mm, Mm, Mm^Xm, Mm^Xm, Mm, Mm, Gg
Gs^Fds, Gs^Fds, Ww, Ww, Ww, Mm, Ww, Mm, Mm, Mm, Ww, Ww, Gs^Es, Gg^Es, Gg, Gs, Gs, Gg, Gs, Gs, Rp, Gg, Gg, Hh^Fds, Hh^Fds, Hh, Hh^Fds, Gg, Gs, Gs, Gg, Mm, Mm, Mm, Mm, Mm, Mm, Mm^Xm, Mm, Mm
Ww, Ww, Gs^Fds, Gs^Fds, Mm^Xm, Ww, Ww, Ww, Ww, Gs^Fds, Ww, Ww, Gs, Gg, Hh, Gs, Hh, Gg, Gg, Rp, Gs^Es, Rp, Gg, Hh^Fds, Hh^Vwsr, Hh^Fds, Gg, Gg, Gs, Gs, Gg, Mm, Mm, Mm, Mm, Mm, Mm, Mm, Mm, Mm
Gs^Fds, Gs^Fds, Mm, Mm, Mm, Mm, Mm, Ww, Gg, Ww, Gg, Gs, Gg, Gg, Hh, Hh, Hh, Hh, Gg, Rp, Gg, Gs, Rp, Gg, Gg, Gg^Es, Gs, Gs, Gs, Gs, Gg, Mm, Mm, Mm, Mm, Mm, Mm, Mm, Mm, Mm
Mm, Mm, Mm, Mm, Mm, Mm, Mm, Gs^Fds, Gs^Fds, Gg, Gd^Vwsr, Gg, Gg, Hh, Hh, Hh^Vwsr, Hh, Hh, Gg, Gs, Gg, Gg, Gg, Rp, Gs, Gs, Gg, Gs, Gs, Gs, Gs, Gg, Mm, Mm, Mm, Mm, Mm, Mm, Mm, Mm
Mm, Mm, Mm, Mm, Mm, Mm, Mm, Mm, Gs^Fds, Gg, Gg, Gg, Hh, Hh, Mm, Hh, Hh, Mm, Rp, Gs, Mm, Gg, Gg, Gg, Gg, Gd^Vwsr, Gg, Gs, Gs, Gs, Gs, Gg, Gg, Mm, Mm, Mm, Mm, Mm, Mm, Mm
Mm, Mm, Mm, Mm, Mm, Mm, Mm, Mm, Gs^Fds, Gs^Fds, Gg, Gg, Gg, Hh, Mm, Mm^Xm, Mm, Mm, Rp, Gg, Gg, Mm^Xm, Gg, Gg, Gg, Gg, Gg, Gg, Gg, Rp, Rp, Gs, Gg, Mm, Mm, Mm, Mm, Mm, Mm, Mm
Hh^Fds, Hh^Fds, Mm, Mm, Mm, Mm, Gs^Fds, Gs^Fds, Gd^Vwsr, Gs^Fds, Gs^Fds, Gg, Gg, Gg, Gg, Gg, Gg, Gg, Rp, Gg, Gg, Mm^Xm, Mm, Gg, Mm, Mm, Mm, Gg, Gg, Gg, Ce, Gs, Gs, Gg, Gg, Mm, Gg, Mm, Mm, Mm
Hh^Fds, Hh^Fds, Hh^Fds, Mm, Hh^Fds, Hh^Fds, Hh^Fds, Gs^Fds, Gs^Fds, Gs^Fds, Gs^Fds, Gg, Mm, Gg, Mm, Gg, Gg, Gg, Rp, Gg, Gg, Gg, Gg, Mm, Mm, Mm^Xm, Mm^Xm, Mm, Mm, Ce, 6 Ke, Ce, Gg, Rp, Rp, Rp, Rp, Gg, Gg, Mm
Hh^Fds, Hh^Fds, Hh^Fds, Hh^Fds, Hh^Fds, Hh^Vwsr, Hh^Fds, Gs^Fds, Gs^Fds, Gs^Fds, Mm, Mm, Mm, Mm, Mm, Mm, Gg, Rp, Cud, Rp, Gg, Gg, Mm, Mm, Ce, Mm, Mm, Mm^Xm, Mm, Ce, Ce, Ce, Gg, Gg, Gg, Gg, Gg, Rp, Rp, Gg
Hh^Fds, Hh^Fds, Hh^Fds, Hh^Fds, Hh^Fds, Hh^Fds, Gs^Fds, Gs^Fds, Gs^Fds, Mm, Mm, Mm^Xm, Mm^Xm, Mm, Mm, Mm, Cud, Rp, Rp, Rp, Cud, Gg, Mm, Ce, 2 Ke, Ce, Mm^Xm, Mm, Mm, Mm, Mm, Mm, Mm, Mm^Xm, Mm, Mm, Mm, Gg, Gg, Rp
Mm, Hh^Fds, Hh^Fds, Hh^Fds, Hh^Fds, Hh^Fds, Mm, Mm^Xm, Mm^Xm, Mm, Mm, Mm, Mm, Mm^Xm, Mm, Cud, Gg, Rp, Cud, Rp, Gg, Cud, Mm, Ce, Ce, Ce, Mm^Xm, Mm^Xm, Mm^Xm, Mm, Mm, Mm, Mm, Mm, Mm, Mm^Xm, Mm, Gg, Gg, Gg
Mm, Mm^Xm, Mm^Xm, Mm, Mm, Mm, Mm, Mm^Xm, Mm^Xm, Mm^Xm, Mm, Mm, Mm, Mm, Mm, Mm, Gg, Cud, 1 Kud, Cud, Gg, Gg, Mm, Mm, Mm, Mm, Mm, Mm^Xm, Mm, Mm, Mm, Mm, Mm, Mm^Xm, Mm^Xm, Mm, Mm, Mm, Gg, Gg
Mm, Mm, Mm, Mm^Xm, Mm, Mm, Mm, Mm, Mm, Mm, Mm, Mm, Mm, Mm, Mm, Mm, Mm, Cud, Cud, Cud, Mm, Mm, Mm, Mm, Mm, Mm, Mm, Mm, Mm, Mm, Mm, Mm^Xm, Mm^Xm, Mm, Mm, Mm^Xm, Mm, Mm, Mm^Xm, Gg
Mm, Mm, Mm, Mm, Mm, Mm^Xm, Mm^Xm, Mm, Mm, Mm, Mm, Mm, Mm, Mm, Mm, Mm, Mm, Mm, Mm, Mm, Mm, Mm, Mm, Mm, Mm, Mm, Mm, Mm, Mm, Mm, Mm, Mm, Mm, Mm, Mm, Mm, Mm, Mm, Mm, Mm
Mm, Mm, Mm, Mm, Mm, Mm, Mm, Mm^Xm, Mm, Mm, Mm, Mm, Mm, Mm, Mm, Mm, Mm, Mm, Mm, Mm, Mm, Mm, Mm, Mm, Mm, Mm, Mm, Mm, Mm, Mm, Mm, Mm, Mm, Mm, Mm, Mm, Mm, Mm, Mm, Mm
Mm, Mm, Mm, Mm, Mm, Mm, Mm, Mm, Mm, Mm, Mm, Mm, Mm, Mm, Mm, Mm, Mm, Mm, Mm, Mm, Mm, Mm, Mm, Mm, Mm, Mm, Mm, Mm, Mm, Mm, Mm, Mm, Mm, Mm, Mm, Mm, Mm, Mm, Mm, Mm
