Gs^Fds, Gs^Fds, Gs^Fds, Gs^Fds, Gs^Fds, Gs^Fds, Gs^Fds, Gs^Fds, Gs, Gg, Gg, Gg, Gg, Gg, Gg, Gg, Gg, Gg, Gg, Gg, Gg, Gg, Gg, Re, Re, Re, Gg, Gg, Gg, Gg, Gg, Gg, Gg, Gg, Gg, Ww, Ww, Gg, Gg, Gg, Gg, Gg, Gg, Gg, Gs, Gg, Gg, Gg, Gg, Gg, Gg, Gg, Ww, Ww, Ww, Gg, Gg
Gs^Fds, Gs^Fds, Gs^Fds, Gs^Fds, Gs^Fds, Gs^Fds, Gs^Fds, Gs^Fds, Gs, Gg, Gg, Gs, Gs, Gg, Gg, Gg, Gg, Gg, Gg, Gg, Gg, Gg, Gg, Re, Re, Re, Gg, Gg, Gg, Gg, Gg, Gg, Gs, Gg, Gg, Gs, Gs, Ww, Ww, Gg, Gg, Gg, Gs, Gs, Gs, Gg, Gg, Gg, Gg, Gg, Gg, Gg, Ww, Ww, Ww, Gg, Gg
Gs^Fds, Gs^Fds, Gs^Fds, Gs^Fds, Gs^Fds, Gs^Fds, Gs^Fds, Gs^Fds, Gs^Fds, Gs, Gs, Gg, Gg, Gg, Gg, Gg, Gg, Gg, Gs, Gg, Gg, Gg, Gg, Re, Re, Re, Gs^Vc, Gg, Gg, Gg, Ce, Gs, Gg, Gs, Gs, Gg, Gg, Gs, Ww, Gg, Gg, Gs, Gs, Gs, Gs, Gg, Gg, Gg, Gg, Gg^Es, Gg^Es, Gg, Ww, Ww, Ww, Gg, Gg
Gs^Fds, Gs^Fds, Gs^Fds, Gs^Fds, Gs^Fds, Gs^Fds, Gs^Fds, Gs^Fds, Gs^Fds, Gs^Fds, Gs, Gg, Gg, Gs, Gg, Gg, Gs, Gg, Gs, Gg, Gg, Gg, Gg, Re, Re, Gs, Gg, Gg, Ce, Ce, 1 Ke, Ce, Gg, Gg^Efm, Gg^Efm, Gg, Gg, Gg, Ww, Gg, Gs, Gs, Gs^Fds, Gs^Fds, Gs^Fds, Gs, Gs, Gg, Gg, Gs^Vc, Gg^Es, Gg, Ww, Ww, Ww, Gg, Gg
Gs^Fds, Gs^Fds, Gs^Fds, Gs^Fds, Gs^Fds, Gs^Fds, Gs^Fds, Gs^Fds, Gs^Fds, Gs^Fds, Gs, Gg, Gg, Gs, Gg, Gg, Gs, Gs, Gs, Gg^Es, Gg, Gg, Gg, Gs, Gs, Gs, Gg, Gg, Ce, Ce, Ce, Ce, Gg, Gg^Efm, Gg, Gg, Gg, Ww, Gg, Gg, Gs, Gs^Fds, Gs^Fds, Gs^Fds, Hh^Fms, Gs^Fds, Gs^Fds, Gs, Gs, Gg, Gg^Es, Gg^Es, Ww, Ww, Ww, Ww, Gg
Gs^Fds, Gs^Fds, Gs^Fds, Gs^Fds, Gs^Fds, Gs^Fms, Gs^Fds, Gs^Fds, Gs^Fds, Gs^Fds, Gs, Gg, Gg, Gg^Es, Gg, Gg, Gg, Gs, Gs, Gs, Gs, Gg, Gg, Gs, Re, Re, Gg, Gg, Gs, Ce, Gg, Gs, Gg, Gg, Gg, Gg^Es, Ww, Wwf, Gs, Gs, Gs^Fds, Gs^Fds, Hh^Fms, Hh^Fms, Hh^Fms, Hh^Fms, Gs^Fds, Gs^Fds, Gs^Fds, Gs, Gg, Gg, Gg^Es, Ww, Ww, Ww, Gg
Gs^Fds, Gs^Fds, Gs^Fds, Gs^Fds, Gs^Fds, Gs^Fds, Gs^Fds, Gs^Fds, Gs^Fds, Gs^Fds, Gs, Gg, Gs, Gs, Gg, Gg, Gg, Gg, Gg, Gs, Gs, Gg, Gg, Re, Re, Re, Gg, Gg, Gg, Gg, Gg, Gg, Gg, Gs^Vc, Gs, Gg, Ww, Gg, Gs, Gs^Fds, Gs^Fds, Hh^Fms, Hh^Fms, Hh^Fms, Hh^Fms, Hh^Fms, Hh^Fms, Gs^Fds, Gs^Fds, Gs, Gg, Gg, Ww, Ww, Ww, Ww, Gg
Gs^Fds, Gs^Fds, Gs^Fds, Gs^Fds, Gs^Fds, Gs^Fds, Gs^Fds, Gs^Fds, Gs, Gs, Gg, Gg, Gs, Gg, Gg, Gg, Gg, Gg, Gs^Es, Gs, Gg, Gg, Gg, Re, Re, Re, Gg, Gg, Gg, Gg, Gs, Gg, Gg, Gg, Gg, Gg, Gg, Ww, Gs, Gs^Fds, Gs^Fds, Hh^Fms, Hh^Fms, Hh^Fms, Hh^Fms, Hh^Fms, Hh^Fms, Gs^Fds, Gs^Fds, Gs, Gg, Gg^Es, Ww, Ww, Ww, Ww, Gg
Gs^Fds, Gs^Fds, Gs^Fds, Gs^Fds, Gs^Fds, Gs^Fds, Gs^Fds, Gs^Fds, Gs, Gg, Gg^Es, Gg, Gg, Gs, Gg, Gg, Gg, Gg, Gs, Gg, Gg, Gg, Gg, Gs, Gs, Re, Gg, Gs^Vc, Gg, Gg, Gs, Gs, Gs, Gg, Gs, Gg, Gg, Ww, Gg, Gs, Gs^Fds, Hh^Fms, Hh^Fms, Hh^Fms, Hh^Fms, Hh^Fms, Hh^Fms, Gs^Fds, Gs, Gs, Gg, Ww, Wo, Wo, Ww, Ww, Gg
Gs^Fds, Gs^Fds, Gs^Fds, Gs^Fds, Gs^Fds, Gs^Fds, Gs, Gs, Gg, Gg, Gg, Gg, Gg, Gg, Gs, Gg, Hh, Gg, Gg, Gg, Gg, Gg, Gg, Gs, Gs, Gg, Gg, Gg, Gg, Gg, Gg, Gs^Es, Gg, Gs, Gg, Gg, Gg, Ww, Gg, Gs, Gs, Gs^Fds, Gs^Fds, Hh^Fms, Hh^Fms, Hh^Fms, Gs^Fds, Gs^Fds, Gs, Gg, Ww, Ww, Wo, Wo, Ww, Gg, Gg
Gs, Gs, Gs, Gs, Gs, Gs, Gg, Gg, Gg, Gg, Hh, Hh, Hh, Hh, Hh, Hh, Hh, Hh, Gg, Gg, Gg, Gg, Gg, Gg, Gg, Gg, Gg, Gg, Gg, Gg, Gg, Gg, Gg, Gg, Gg, Gg, Gg, Wwf, Ww, Gs, Gg, Gs, Gs, Gs^Fds, Gs^Fds, Gs^Fds, Gs, Gs, Gg, Gg, Ww, Ww, Ww, Ww, Gg, Gg, Gg
Gg, Gg, Gg, Gs, Gg, Gg, Gg, Gg, Gg, Gg, Hh, Hh, Hh, Hh^Fds, Hh^Fds, Hh, Hh, Hh, Gg, Gg, Gs, Gs, Gs, Gg, Gg, Gg, Gg, Gg, Gg, Gg, Hh, Gg, Hh, Hh, Gg, Gg, Gg, Gg, Gg, Ww, Gg, Gg, Gg, Gs, Gs, Gs, Gg, Gg, Gg, Ww, Wo, Ww, Ww, Gg, Gg, Gg, Gg
Gg, Gg, Gg, Gg, Gg, Gg, Gg, Gg, Gg, Gg, Gg, Hh, Hh, Hh^Fds, Hh^Fds, Hh^Fds, Hh, Hh, Hh, Gs, Gs, Gs, Gs, Gs, Hh, Hh, Hh, Gg, Gg, Gg, Hh, Hh, Hh^Fds, Hh, Hh, Gg, Gg, Gg, Gg, Ww, Gg, Gg, Gg, Gs, Gg, Gg, Gg, Gg, Ww, Ww, Wo, Ww, Gg, Gg, Gg, Gg, Gg
Gg, Gg, Gg, Gg, Hh^Fds, Gg, Gg, Gg, Gg, Gg, Gg, Hh, Hh^Fds, Hh^Fds, Hh^Fds, Hh^Fds, Hh, Hh, Hh, Hh, Gs, Gg, Gg, Gg, Hh, Hh, Hh^Fds, Hh, Hh, Gg, Gg, Hh, Hh, Hh, Hh, Gg, Gg, Gg, Gg, Wwf, Ww, Gg, Gg, Gg, Gg, Gg, Ww, Ww, Wo, Wo, Ww, Ww, Gg, Gg, Gg, Gg, Gg
Gg, Gg, Gg, Hh^Fds, Hh^Fds, Hh^Fds, Hh^Fds, Gg, Gg, Gg, Gg, Hh, Hh, Hh^Fds, Hh, Hh^Fds, Hh, Hh, Md, Md, Gs, Gg, Gg, Md, Hh, Hh^Fds, Hh^Fds, Hh, Hh, Gg, Gg, Hh, Gg, Gg, Gg, Gg, Gg, Gg, Gg, Gg, Ww, Gg, Gg, Gg, Gg, Ww, Ww, Wo, Ww, Ww, Gg, Gg, Gg, Gg, Gg, Gg, Ww
Gg, Gg, Gg, Hh^Fds, Hh^Fds, Hh^Fds, Hh^Fds, Hh^Fds, Gg, Gg, Gg, Hh, Hh, Hh, Hh, Hh, Gg, Hh, Hh, Md, Gs, Gs, Gg, Md, Hh, Hh, Hh, Hh, Hh, Gg, Gg, Gg, Gg, Gg, Gg, Gg, Gg, Gg, Gs^Vc, Gg, Gg, Ww, Ss, Gg, Ww, Ww, Wo, Ww, Ss, Gg, Gg, Gg, Gg, Gg, Gg, Ww, Gg
Gg, Gg, Gg, Gg, Hh^Fds, Hh^Fds, Gg, Gg, Gg, Gg, Gg, Hh, Hh, Hh, Hh, Hh, Gg, Gg, Gs, Gs, Gs, Gs, Gg, Gg, Hh^Vhh, Hh, Hh, Hh, Gg, Gg, Gg, Gg, Gg, Gg, Gg, Gg, Gg, Gg, Gg, Gg, Gg, Ww, Ww, Ww, Wo, Wo, Ww, Ww, Ww, Ww, Ww, Gg, Ww, Ww, Ww, Ww, Gg
Gg, Gg, Gg, Gg, Gg, Hh^Fds, Gg, Gg, Gg, Gg, Gg, Gg, Gg, Hh, Hh, Hh^Vhh, Gg, Gs, Gg, Gg, Gs, Gg, Gg, Gg, Gg, Gg, Gg, Gg, Gg, Gg, Gg, Gg, Gg, Gg, Gg, Gg, Gg, Gg, Gg, Gg, Ww, Ww, Wo, Wo, Ww, Ww, Ww, Ss, Gg, Gg, Gg, Ww, Gg, Gg, Gg, Gg, Gg
Gg, Gg, Gg, Gg, Gg, Gg, Gg, Gg, Gg, Gg, Gg, Gg, Gg, Gg, Gg, Gg, Gg, Gg, Gg^Es, Gg, Gg, Gs, Gs, Gg, Gg, Gs, Gs, Gg, Gg, Gg, Gs, Gs, Gs, Gs, Gg, Gg, Gg, Gg, Ww, Ww, Wo, Wo, Ww, Ww, Gg, Ww, Gg, Gg, Gs^Fms, Gg, Gg, Gg, Gg, Gg, Gg, Gg, Gg
Gg, Gg, Gg, Gg, Gg, Gg, Gg, Gg, Gg, Gg, Gg, Gg, Gg, Gg, Gg, Gg, Gg, Gg, Gg, Gg^Es, Gg, Gg, Gs, Gs, Gg, Gg, Gg, Gg, Gs, Gs, Gg, Gs, Gg, Gg, Gg^Es, Gg, Ww, Ww, Wo, Ww, Ww, Ww, Gg, Gg, Gg, Gg, Gg, Gs^Fms, Gs^Fms, Gs^Fms, Gs^Fms, Gs^Fms, Gs^Fms, Gg, Gg, Gg, Gg
Gg, Gg, Gg, Gg, Gg, Gg, Gs, Gg, Gg, Gg, Gs^Vc, Gg, Gg, Gg, Gg^Efm, Gg^Efm, Gg^Efm, Gg, Gg, Gg, Gg^Es, Gg, Gg, Gg, Gg, Gg, Gg, Gg, Gs, Gg, Gg, Gs, Gg, Gg^Es, Wwf, Ww, Ww, Ww, Ww, Ww, Gg, Gg, Gg, Gg, Gg, Gg, Gs^Fms, Gs^Fms, Hh^Fms, Hh^Fms, Hh^Fms, Gs^Fms, Gs^Fms, Gg, Gg, Gg, Gg
Gg, Gg, Gg, Gg, Gg, Gs, Gg, Gg, Gg, Gg, Gg^Es, Gg, Gg, Gg^Efm, Gg^Efm, Gg^Efm, Gg^Efm, Gg^Efm, Gg, Gg, Gg^Efm, Gg, Gg, Gg, Gg, Gg, Gs, Gs, Gs, Gg, Gg, Gg, Gg^Es, Gg^Es, Wwf, Wwf, Ww, Ww, Gg^Es, Gg, Gg, Gg, Gg, Gg, Gg, Gs^Fms, Hh^Fms, Hh^Fms, Hh^Fms, Hh^Fms, Hh^Fms, Hh^Fms, Gs^Fms, Gg, Gg, Gg, Gg
Gg, Gg, Gg, Gg, Gg^Es, Gs, Gg, Gs, Gs, Gg^Es, Gg, Gg, Gg, Gg, Gg, Gg^Efm, Gg, Gg, Gg, Gg, Gg^Efm, Gg, Gg^Efm, Gg, Gg, Gg, Gg, Gg, Gs, Gg, Gg, Gg, Gg^Es, Wwf, Wwf, Wwf, Wwf, Ww, Gg^Es, Gg, Gg, Gg, Gg, Gg, Gg, Gs^Fms, Hh^Fms, Hh^Fms, Hh^Fms, Hh^Fms, Hh^Fms, Hh^Fms, Hh^Fms, Gs^Fms, Gg, Gg, Gg
Gg, Gg, Gg, Gg, Gs^Es, Gs, Gg, Gg, Gg, Gs, Gg, Gg, Gg, Gg, Gg, Gg^Es, Gg, Gg, Gg, Gg, Gg^Efm, Gg^Efm, Gg^Efm, Gg, Gs, Gs, Gs, Gs, Gg, Gg, Gg^Es, Gg^Es, Ww, Ww, Ww, Wwf, Gg^Es, Gg^Es, Gg, Gg, Gg, Gg, Gg, Gg, Gs^Fms, Gs^Fms, Hh^Fms, Hh^Fms, Hh^Fms, Hh^Fms, Hh^Fms, Hh^Fms, Hh^Fms, Gs^Fms, Gg, Gg, Gg
Gg, Gg, Gg, Gg, Gg, Gg, Gg^Es, Gg, Gg^Es, Gg^Es, Gg, Gg, Gg^Efm, Gg^Efm, Gg^Es, Gg^Es, Gg^Es, Gg, Gg, Gg^Efm, Gg^Efm, Gg^Efm, Gg, Gs, Gs, Gs, Gg, Gg, Gg, Gg^Es, Wwf, Ww, Ww, Wo, Ww, Ww, Gg^Es, Gg, Gg, Gg, Gg, Gg, Gg, Gg, Gg, Gs^Fms, Gs^Fms, Hh^Fms, Gs^Fms, Hh^Fms, Gs^Fms, Hh^Fms, Gs^Fms, Gs^Fms, Gg, Gg, Gg
Gg, Gg, Gg, Gg, Gg, Gg, Gs, Gs, Gs^Es, Gg, Gs, Gg, Gg^Efm, Gg, Gg^Efm, Gg^Efm, Gg, Gg^Es, Gg, Gg^Efm, Gg, Gg^Efm, Gg, Gg, Gg, Gg, Gg, Gg, Gg^Es, Gg^Es, Wwf, Wwf, Ww, Ww, Gg^Es, Gg^Es, Gg, Gg, Gg, Gg, Gg, Gg, Gg, Gg, Gg^Es, Gg, Gg, Gs^Fms, Gg, Gs^Fms, Gg, Gs^Fms, Gg, Gg, Gg, Gg, Gg
Gg, Gg, Gg, Gg^Es, Gg, Gg, Gg, Gg, Gg^Es, Gs, Gg, Gg, Gg, Gg, Gg^Efm, Gg, Gg, Gg^Es, Gg, Gg, Gg, Gg, Gg, Gg, Gg, Gg, Gg, Gg, Ww, Wwf, Wwf, Wwf, Wwf, Gg^Es, Gg, Gg, Gg, Gg, Gg, Gg, Gs, Gg, Gs, Gg, Gg, Gg, Gs, Gg, Gg, Gg, Gg, Gg, Gg, Gg^Es, Gg, Gg, Gg
Gg, Gg, Gg, Gg^Es, Gs, Gg, Gg, Gs^Es, Gs, Gg, Gg, Gs, Gg, Gs, Gg^Efm, Gg, Gg, Gg, Gs, Gg, Gg, Gg, Gg^Es, Gg, Gg, Gg, Gg, Gg, Ww, Ww, Ww, Wwf, Gg^Es, Gg^Es, Gg, Gg, Gs, Gg, Gs, Gs, Gs, Gs, Gs^Fms, Gs, Gs, Gs, Gs, Gg, Gg, Gg, Gg, Gg, Gg, Gg, Gs^Fms, Gs^Fms, Gs^Fms
Gg, Gg, Gg, Gg, Gs, Gg, Gg, Gg, Gg, Gg, Hh, Gg, Gg, Gg, Gg, Gg, Gs, Gs, Gs^Fms, Gs^Fms, Gs, Gg, Gg, Gg, Gg, Gg, Ww, Ww, Wo, Ww, Ww, Gg^Es, Gg, Gg, Gs, Gs, Gs^Fms, Gs, Gs^Fms, Gs^Fms, Gs^Fms, Gs^Fms, Gs^Fms, Gs^Fms, Gs^Fms, Gs^Fms, Gs^Fms, Gs, Gs, Gg, Gg^Es, Gg, Gg, Gs^Fms, Gs^Fms, Gs^Fms, Gs^Fms
Gg, Gg, Gg, Gg, Gs, Gg, Gs, Gg, Gg, Hh, Hh^Fms, Hh, Hh, Gg, Gg, Gg, Gs, Gs^Fms, Gs^Fms, Gs^Fms, Gs, Gg, Gg, Gg, Gg, Ww, Wo, Wo, Ww, Ww, Gg, Gg, Gg, Gg, Gs, Gs^Fms, Gs^Fms, Gs^Fms, Gs^Fms, Gs^Fms, Hh^Fms, Hh^Fms, Hh^Fms, Gs^Fms, Gs^Fms, Gs^Fms, Gs^Fms, Gs^Fms, Gs, Gg, Gg, Gg, Gs^Fms, Gs^Fms, Gs^Fms, Gs^Fms, Gs^Fms
Ww, Gg, Gs, Gg, Gg, Gg, Gg, Gs, Gg, Hh, Hh, Hh^Fms, Hh, Gg, Gs, Gg, Gg, Gs, Gg, Gs, Gs, Gg, Gg, Gg, Gg, Ww, Wo, Ww, Gg, Gg, Gg, Gg, Gg, Gs, Gs^Fms, Gs^Fms, Gs^Fms, Gs^Fms, Hh^Fms, Hh^Fms, Hh^Fms, Hh^Fms, Hh^Fms, Gs^Fms, Gs^Fms, Gs^Fms, Gs^Fms, Gs^Fms, Gs, Gg, Gg, Gs^Fms, Gs^Fms, Gs^Fms, Gs^Fms, Gs^Fms, Gs^Fms
Ww, Ww, Gg, Gs, Gs, Gg, Gg, Gg, Gg, Hh, Gg, Hh, Gs, Gg, Gg, Gs, Gs, Gg, Gg, Gg, Gg, Gg^Es, Gg, Gg, Gg, Ww, Wo, Ww, Gg, Gg, Gg, Gg, Gg, Gs, Gs^Fms, Gs^Fms, Gs^Fms, Gs^Fms, Hh^Fms, Hh^Fms, Hh^Fms, Hh^Fms, Hh^Fms, Hh^Fms, Gs^Fms, Gs^Fms, Gs^Fms, Gs^Fms, Gs, Gg, Gg, Gs^Fms, Gs^Fms, Gs^Fms, Gs^Fms, Gs^Fms, Gs^Fms
Gg, Ww, Ww, Gg, Gg, Gs, Gg, Gg, Ww, Gg, Gs, Gg, Gg, Gg, Gg, Gg, Gs, Gg, Gs, Gg, Gg, Gg, Gg, Gg, Gg, Ww, Wo, Ww, Gg, Gg, Gg, Gg, Gg, Gs, Gs^Fms, Gs^Fms, Gs^Fms, Gs^Fms, Gs^Fms, Hh^Fms, Hh^Fms, Hh^Fms, Hh^Fms, Hh^Fms, Gs^Fms, Gs^Fms, Gs^Fms, Gs^Fms, Gs, Gg, Gg, Gg, Gs^Fms, Gs^Fms, Gs^Fms, Gs^Fms, Gs^Fms
Gg, Gg, Ww, Gg, Gs, Gs, Gg, Ww, Ss, Ww, Ww, Gg, Gg, Gg, Gs, Gg, Gg, Gg, Gg, Gg, Gg, Gg, Gg, Gg, Gg, Ww, Wo, Ww, Ww, Gg, Gg, Gg, Gg, Gs, Gs^Fms, Gs^Fms, Gs^Fms, Gs^Fms, Gs^Fms, Gs^Fms, Gs^Fms, Hh^Fms, Gs^Fms, Gs^Fms, Gs^Fms, Gs^Fms, Gs^Fms, Gs^Fms, Gs, Gg, Gg, Gg, Gs^Fms, Gs^Fms, Gs^Fms, Gs^Fms, Gs^Fms
Gg, Gg, Gg, Ww, Ww, Wwf, Ww, Ww, Gs^Vc, Gg, Gg, Ww, Gg, Gs, Gg, Gg, Gg, Gg^Es, Gg, Gg, Gg, Gg, Gg, Gg, Gg, Ww, Ww, Ww, Wo, Ww, Ww, Gg, Gg, Gs, Gs, Gg^Ve, Gs, Gs^Fms, Gs^Fms, Gs^Fms, Gs, Gs^Fms, Gs, Gs^Fms, Gs^Fms, Gs^Fms, Gs, Gs, Gg, Gg, Gg^Ve, Gs^Fms, Gs^Fms, Gs^Fms, Gs^Fms, Gs^Fms, Gs^Fms
Gg, Gg, Gs, Gg, Gg, Gs, Gg, Gg, Gg, Gg, Gg, Wwf, Ww, Gg, Ww, Gg, Gg, Gg, Gg, Gg, Gg, Gg, Gg, Gg, Gg, Gg, Ww, Ww, Wo, Ww, Ww, Gg, Gg, Gg, Gg, Gs, Gs, Gs, Gs, Gs, Gs, Gs, Gg, Gs, Gs, Gs, Gg, Gg^Es, Gg, Gg, Gs^Fms, Gs^Fms, Gs^Fms, Gs^Fms, Gs^Fms, Gs^Fms, Gs^Fms
Gg, Gg, Gs, Gs, Gg, Gg, Gg, Gg, Gg, Gg, Gg^Es, Gs, Gg, Ww, Gg, Ww, Ww, Wwf, Ww, Gg, Gg, Gg, Gg, Gg, Gg, Gg, Ss, Ww, Ww, Wo, Ww, Gg, Gg, Gg, Gs, Gs, Gg, Gg, Gg, Gg, Gg, Gg, Gg, Gg, Gg, Gg, Gg, Gg, Gg, Gg, Gg, Gs^Fms, Gs^Fms, Gs^Fms, Gs^Fms, Gs^Fms, Gs^Fms
Gg, Gg, Gg, Gg, Gg, Gg, Gg^Es, Gg, Gg, Gg, Gg, Gg, Gs^Fms, Gs, Gg, Gg, Gg, Gg, Gg, Ww, Ww, Ss, Ss, Gg, Ss, Ss, Ss, Ss, Ss, Ww, Ww, Ww, Ww, Gg, Gg, Gg, Gg, Gg, Ds, Ds, Ds, Gg, Gg, Gg, Ds, Gg, Gg, Gg, Gg, Gg, Gg, Gg, Gg, Gg, Gg, Gs^Fms, Gg
Gg, Gg, Gg, Gg, Gg, Gg^Es, Gg^Es, Gg, Gg, Gg, Gs^Fms, Gs^Fms, Gs^Fms, Gs^Fms, Gs^Fms, Gg^Es, Gg, Gg, Gg, Ss, Ss, Ww, Ss, Ss, Ss, Ss, Ss, Ss, Ss, Ww, Ww, Ww, Ww, Gg, Gs, Gs, Gg, Gs, Gs, Gs, Gs, Ds, Ds, Ds, Ds, Ds, Gg, Gg, Gg, Gg, Gg^Es, Gg, Gg, Gg, Gg^Es, Gg, Gg
Gg, Gg, Gg, Gg, Gg, Gg, Gg, Gg, Gs^Fms, Gs^Fms, Gs^Fms, Gs^Fms, Gs^Fms, Gs^Fms, Gg, Gg, Gg, Gg, Gg, Ss, Ss, Ww, Ww, Ss^Vhs, Ss, Ss, Ss, Ss, Ss, Ss, Ww, Ds, Ww, Gg, Ds, Gg, Ds, Gs, Gs, Gs, Ss, Gs, Gs, Gs, Gs, Ds, Ds, Gg, Gg, Gg, Gg, Gg, Gs, Gg, Gg, Gg, Gg
Gg, Gg, Gg, Gs, Gs, Gg, Gg, Gg, Gs^Fms, Gs^Fms, Gs^Fms, Gs^Fms, Gs^Fms, Gs^Fms, Gg, Gg, Gg, Gg, Ss, Ss, Ss, Ss, Ss, Ww, Ss, Ss, Ss, Ss, Ss, Ss, Ww, Ds, Ww, Ds, Gs, Ds, Gs, Gs, Gs, Ss, Ss, Ss, Gs, Gs, Gs, Gs, Gs, Ds, Ds, Gg, Gg, Gs, Gg, Gg, Gg, Gg, Gg
Gg, Gg, Gg, Gg, Gg, Gs, Gg, Gg, Gg, Gg, Gg^Es, Gs^Fms, Gg, Gg, Gg, Gg, Gg, Ss, Ss, Ss, Ww, Ss, Ss, Ww, Ss, Ss, Ss, Ss, Ww, Ww, Ds, Ww, Ww, Ds, Gs, Gs, Gs, Gs, Ss, Ss, Ss^Vhs, Ss, Ss, Gs, Gs, Gs, Gs, Gs, Ds, Gg, Gs, Gs, Gg, Gs, Gg, Gg, Gg
Gg, Gg, Gg, Gg, Gg, Gs, Gg^Es, Gg, Gg, Gg, Gg^Es, Gg, Gg, Gg, Gg, Gg, Gg, Ss, Ww, Ww, Ww, Ww, Ww, Ww, Ww, Ss, Ss, Ss, Ww, Ww, Ww, Ww, Ds, Ds, Gs, Gs, Gs, Ss, Ss, Ss, Ss, Ss, Ss, Ss, Gs, Gs, Gs, Gg, Gg, Ds, Gg, Gg, Gg, Gs, Gg, Gg, Gg
Gs^Fms, Gg, Gg, Gg, Gs, Gs, Gg, Gg, Gg, Gg^Es, Gg^Es, Gg^Es, Gg, Gg, Gs, Gg, Gg, Ss, Ww, Ww, Ds, Ds, Ds, Ds, Ds, Ww, Ww, Ww, Ds, Ds, Ww, Ww, Ds, Gs, Ds, Gs, Gs, Ss, Ss, Ss, Ss, Ss^Emf, Ss, Ss, Gg, Gs, Ds, Ds, Gg, Gg, Ds, Gg, Gg, Gs, Gg, Gg, Gg
Gs^Fms, Gs^Fms, Gs^Fms, Gg, Gg, Gg, Gs, Gg, Gg^Es, Gg^Es, Gg, Gg, Gg, Gs, Gg, Gg, Ww, Ww, Ww, Ds, Ww, Ww, Ww, Ww, Ds, Ww, Ww, Ds, Ww, Ww, Ww, Ds, Ds, Ds, Ds, Gs, Ss, Ss, Ss, Ss, Ss, Ss, Ss, Ss, Gg, Ds, Ds, Ds, Ds, Gg, Ds, Gg, Gg, Gg, Gg, Gg, Gg
Gs^Fms, Gs^Fms, Gs^Fms, Gg, Gg, Gg, Gg, Gg^Es, Gg^Es, Gg, Gg, Gg, Gs, Gs, Gg, Gg, Ww, Ww, Ww, Ww, Ss, Ss, Ss, Ww, Ww, Ww, Ww, Ds, Ww, Ww, Ds, Ds, Gs^Vht, Ds, Ds, Ss, Ss, Ss, Ss^Emf, Ss, Ss, Ss, Ss, Ss, Gs, Ds, Ds, Ds, Ds, Gg, Gg, Gg, Gs^Ft, Gg, Gg, Gg, Gg
Gs^Fms, Gs^Fms, Gs^Fms, Gs^Fms, Gg, Gg, Gg, Gg, Gg, Gg, Hh^Fms, Gg, Gg, Gg, Gg, Ww, Ds, Ww, Ss, Ss, Ss, Ss, Ss, Ss, Ss, Ww, Ss, Ww, Ss, Ss, Ss, Ds, Ds, Ds, Ds, Ss, Ss, Ss, Ss, Ss, Ss, Ss, Ss, Gg, Gs, Gs, Gs, Ds, Gg, Gg, Gs^Ft, Gs^Ft, Gs^Ft, Gs^Ft, Gg, Gg, Gg
Gs^Fms, Gs^Fms, Gs^Fms, Gs^Fms, Gg, Gg^Es, Gg, Gg, Gg, Hh^Fms, Hh^Fms, Hh^Fms, Gg, Gg, Gg, Ww, Ds, Ww, Ss, Ss, Ss, Ss^Vhs, Ss, Ss, Ss^Emf, Ss, Ss, Ss, Ss, Ss, Ss, Ss, Ds, Ds, Gs, Ds, Ds, Ss, Ss, Ss, Ss, Ss, Ds, Ds, Gs, Gs, Gg, Gg, Gs, Gg, Gs^Ft, Gs^Ft, Gs^Ft, Gs^Ft, Gs^Ft, Gg, Gg
Gs^Fms, Gs^Fms, Gs^Fms, Gs^Fms, Gg, Gg, Gg, Gg, Gg, Hh^Fms, Hh^Fms, Hh^Fms, Gg, Gg, Gg, Ww, Ds, Ww, Ww, Ss, Ss, Ss, Ss^Emf, Ss, Ss, Ss, Ss, Ss, Ss, Ss, Ss, Ss, Ds, Gs, Ds, Ds, Gs, Ds, Ds, Ss, Ds, Ds, Gs, Gs, Gg, Gg, Gs^Vht, Gs, Gg, Gg, Gg, Gs^Ft, Gg, Gs^Ft, Ds, Ds, Ds
Gs^Fms, Gs^Fms, Gs^Fms, Gg, Gg, Gg, Gg, Gg, Gg, Gg, Gg^Es, Gg, Gg, Gg, Gg, Ww, Ww, Ds, Ww, Ss, Ss, Ss, Ss, Ss, Ss, Ss, Ss, Ss, Ss, Ss, Ss, Ss, Ds, Gs, Ds, Gs, Gs, Gs, Gs, Ds, Gs, Gs, Gs^Ft, Gs^Ft, Gg, Gg, Gg, Gg, Gg, Gg, Gg, Gg, Gg, Ds, Ds, Ds, Ds
Gs^Fms, Gs^Fms, Gs^Fms, Gs^Fms, Gg, Gg, Gg^Es, Gg^Es, Gg, Gg^Es, Gg, Gg, Gg, Gg, Gg, Gg, Ww, Ww, Ww, Ww, Ww, Ss, Ss, Ss, Ss, Ss, Ss, Ss^Emf, Ss, Ss, Ds, Ds, Gs, Gs, Ds, Gs, Gs, Gs, Gs, Gs, Gg, Gs^Ft, Gs^Ft, Gs^Ft, Gs^Ft, Gg, Gg, Gs, Ce, Gg, Gs, Gs^Vht, Gg, Ds, Ds, Ds, Ds
Gg, Gs^Fms, Gs^Fms, Gg, Gg^Es, Gg^Es, Gg, Gg, Gg, Gg, Hh, Hh, Hh, Gg^Es, Gg, Gg^Es, Gg, Ww, Ww, Ww, Ww, Ww, Ww, Ss, Ss, Ss, Ss, Ss, Ss, Ss, Ds, Gs, Ds, Ds, Ss, Ss, Ss, Gs, Gs, Gs, Gs, Gs^Ft, Gs^Ft, Gs^Ft, Gg, Gg, Gg, Ce, 2 Ke, Ce, Gg, Gg, Ds, Ds, Ds, Ds, Ds
Gg, Gg, Gg, Gg, Gg, Gg, Gg, Gg, Gg, Gg, Hh, Hh, Hh, Gg, Hh, Gg, Gg, Gg, Gg, Ww, Ww, Ww, Ww, Ss, Ss, Ss, Ss, Ss, Ss, Ds, Ds, Gs, Ds, Ss, Ss, Ss, Ss, Ss, Ss, Gs, Gs, Gs, Gs, Gs^Ft, Gg, Gs^Vht, Gs, Ce, Ce, Ce, Gg, Gg, Ds, Ds, Ds, Ds, Ds
Gg, Gg, Gs, Gg, Gs, Gg, Gs, Gg, Gg^Es, Gg^Es, Gg, Hh, Hh, Hh, Gg, Gg, Gg, Gg, Gg, Gg, Ww, Ww, Ww, Ww, Ss, Ss, Ss, Ss, Ds, Ds, Ds, Ds, Ss, Ss, Ss, Ss^Emf, Ss, Ss, Ss, Gs, Gs, Gs, Gg, Gg, Ds, Gg, Gs, Gs, Gg, Gg, Gg, Gg, Ds, Ds, Ds, Ds, Ds
Gg, Gs, Gs, Gs, Gs, Gs, Gs^Ft, Gs, Gs, Gg, Gg, Gg, Gg, Gg, Gs, Gg, Gs, Gs, Gs, Gg, Gg, Ww, Ww, Ww, Ww, Ss, Ss, Ss, Ds, Ds, Ds, Ds, Ss, Ss, Ss, Ss^Vhs, Ss, Ss, Ss, Ss, Gg, Gs, Ds, Ds, Ds, Ds, Ds, Gg, Gg, Gg, Gs^Ft, Gg, Gg, Ds, Ds, Ds, Ds
Gs, Gs, Gs^Ft, Gs^Ft, Gs^Ft, Gs^Ft, Gs^Ft, Gs^Ft, Gs^Ft, Gs, Gs, Gg, Gs, Gs, Gs, Gs, Gs^Ft, Gs, Gs, Gs, Gg, Ww, Ww, Ww, Ww, Ww, Ww, Ww, Ww, Ds, Ds, Gs, Gs, Ss, Ss, Ss, Ss^Emf, Ss, Ss, Ss, Gg, Ds, Gg, Ds, Ds, Ds, Ds, Gg, Gg, Gs^Ft, Gs^Ft, Gs^Ft, Gs^Ft, Gg, Ds, Ds, Ds
Gs^Ft, Gs^Ft, Gs^Ft, Gs^Ft, Gs^Ft, Gs^Ft, Gs^Ft, Gs^Ft, Gs^Ft, Gs^Ft, Gs^Ft, Gs, Gg, Gs, Gs^Ft, Gs^Ft, Gs^Ft, Gs^Ft, Gs^Ft, Gs, Gs, Gg, Gg, Ww, Ww, Ww, Ww, Ww, Ww, Ww, Ds, Gs, Gs, Ss, Ss, Ss, Ss, Ss, Ss, Ss, Ds, Ds, Gg, Gg, Ds, Ds, Ds, Ds, Gg, Gs^Ft, Gs^Ft, Gs^Ft, Gs^Ft, Gg, Gg, Ds, Ds
Gs^Ft, Gs^Ft, Gs^Ft, Gs^Ft, Gs^Ft, Gs^Ft, Gs^Ft, Gs^Ft, Gs^Ft, Gs^Ft, Gs^Ft, Gs, Gg, Gs, Gs^Ft, Gs^Ft, Gs^Ft, Gs^Ft, Gs^Ft, Gs^Ft, Gs^Ft, Gs^Ft, Gs^Ft, Gg, Gg, Ww, Ww, Ww, Ww, Ww, Ww, Ds, Ds, Ds, Ds, Ss, Gs, Ss, Gs, Gs, Ds, Gg, Gg, Ds, Gg, Ds, Ds, Ds, Gg, Gs^Ft, Gs^Ft, Gs^Ft, Gg, Gg, Gg, Gg, Gg
Gs^Ft, Gs^Ft, Gs^Ft, Gs^Ft, Gs^Ft, Gs^Ft, Gs^Ft, Gs^Ft, Gs^Ft, Gs^Ft, Gs^Ft, Gs, Gs, Gg, Gs^Ft, Gs^Ft, Gs^Ft, Gs^Ft, Gs^Ft, Gs^Ft, Gs^Ft, Gs^Ft, Gs^Ft, Gs^Ft, Gs^Ft, Gg, Gg, Ww, Ww, Ww, Ww, Ds, Ww, Ww, Ww, Ds, Ds, Gs, Ds, Ds, Gs, Gg, Gg, Gg, Gg, Ds, Gg, Ds, Gg, Gg, Gg, Gg, Gg, Gg, Gg, Gg, Gg
Gs^Ft, Gs^Ft, Gs^Ft, Gs^Ft, Gs^Ft, Gs^Ft, Gs^Ft, Gs^Ft, Gs^Ft, Gs^Ft, Gs^Ft, Gs^Ft, Gs, Gs, Gs, Gs^Ft, Gs^Ft, Gs^Ft, Gs^Ft, Gs^Ft, Gs^Ft, Gs^Ft, Gs^Ft, Gs^Ft, Gs^Ft, Gg, Gg, Gg, Gg, Ww, Ww, Ww, Ds, Ds, Ds, Ww, Ww, Ds, Gs, Gs, Gs, Gs, Gg, Gg, Ds, Ds, Gg, Gg, Gg, Gg, Gg, Gg, Gs, Gg, Gg, Gg, Gg
Gs^Ft, Gs^Ft, Gs^Ft, Gs^Ft, Gs^Ft, Gs^Ft, Gs^Ft, Gs^Ft, Gs^Ft, Gs^Ft, Gs^Ft, Gs^Ft, Gs, Gg, Gs, Gs^Ft, Gs^Ft, Gs^Ft, Gs^Ft, Gs^Ft, Gs^Ft, Gs^Ft, Gs^Ft, Gs^Ft, Gs, Gs, Gg, Gg, Gg, Ww, Ww, Ww, Ww, Ww, Ds, Ds, Ww, Ds, Ds, Gs, Gg, Gs, Gs, Gg, Gg, Gg, Gs, Gs, Gs, Gs^Vht, Gs, Gs, Gg, Gg, Gg, Gg, Gg
Gs^Ft, Gs^Ft, Gs^Ft, Gs^Ft, Gs^Ft, Gs^Ft, Gs^Ft, Gs^Ft, Gs^Ft, Gs^Ft, Gs, Gs, Gg, Gg, Gg, Gs, Gs, Gs^Ft, Gs, Gs, Gs, Gs, Gs, Gs, Gg, Gg, Gg, Gg, Gg, Gg, Gg, Ww, Gg, Ww, Ww, Ds, Ww, Ds, Ww, Ds, Gg, Gg, Gg, Gs, Gs, Gg, Gg, Gg, Gs, Gs, Gg, Gg, Gg, Gg, Gg, Gg, Gg
Gs^Ft, Gs^Ft, Gs, Gs, Gs, Gs^Ft, Gs^Ft, Gs^Ft, Gs, Gs, Gg, Gg, Gg, Gg, Gg, Gg, Gg, Gs, Gs, Gs, Gg, Gg, Gs, Gg, Gs, Gg, Gg, Gg, Gs, Gg, Gg, Gg, Gg, Ww, Ww, Ww, Ww, Ww, Ww, Ww, Gg, Gg, Gg, Gg, Gs, Gs, Gs, Gg, Gg, Gg, Gs, Gg, Gs, Gs, Gg, Gg, Gg
Gs, Gs, Gg, Gg, Gg, Gs, Gs, Gs, Gg, Gg, Gg, Gs, Gs^Vc, Gg, Gg, Gg, Gg, Gs, Gg, Gg, Gg, Gs, Gg, Gs, Gs, Gs, Gs, Gs, Gs^Vc, Gs, Gs, Gg, Gg, Gg, Gg, Gg, Gg, Ww, Wo, Ww, Ww, Gg, Gs, Gs, Gg, Gs, Gg, Gs, Gg, Gg, Gg, Gs, Gg, Gg, Gg, Gg, Gg
Gg, Gg, Gg, Gg, Gg, Gg, Gg, Gg, Gg, Gg, Gg, Gs, Gs, Gg, Gg, Gg, Gg, Gg, Gs, Gg, Gg, Gg, Gg, Gg, Gg, Gs, Gg, Gs, Gg, Gs, Gg, Gs, Gg, Gg, Gg, Gg, Gg, Ww, Ww, Wo, Ww, Gg, Gg, Gg, Gg, Gg, Gg, Gg, Gg, Gg, Gg, Gg, Gg, Gg, Gg, Gg, Gg
Gg, Gg, Gg, Gg, Gs, Gs, Gs, Gs, Gs, Gs, Gs, Gs, Gg, Gg, Gs, Gg, Gg, Gs, Gg, Gg, Gg, Gg, Gg, Gg, Gg, Gg, Gg, Gg, Gg, Gg, Gg, Gg, Gg, Gg, Gg, Gg, Gg, Gg, Ww, Wo, Ww, Gg, Gg, Gg, Gg, Gg, Gg, Gg, Gg, Gg, Gg, Gg, Gll^Ftr, Gg, Gg, Gg, Gg
Gg, Gg, Gg, Gs, Gg, Gg, Gg, Gg, Gg, Gg, Gg, Gg, Gg, Gg, Gg, Gs, Gg, Gg, Gg, Gg, Gg, Gg, Gg, Gg, Gg, Gg, Gg, Gg, Gg, Gg, Gg, Gg, Gg, Gg, Gg, Gg, Gg, Gg, Ww, Wo, Wo, Ww, Gg, Gg, Gll^Ftr, Gll^Ftr, Gll^Ftr, Gll^Ftr, Gll^Ftr, Gg, Gll^Ftr, Gll^Ftr, Gll^Ftr, Gll^Ftr, Gll^Ftr, Gg, Gg
Gs, Gg, Gg, Gg, Gg, Gg, Gg, Gg, Gg, Gg, Gg, Gg, Gg, Gg, Gg, Gg, Gg, Gg, Gg, Gg, Gll^Ftr, Gg, Gll^Ftr, Gg, Gll^Ftr, Gg, Gg, Gg, Gg, Gg, Gg, Gg, Gg, Gg, Gll^Ftr, Gg, Gg, Gg, Gg, Ww, Wo, Ww, Gll^Ftr, Gll^Ftr, Gll^Ftr, Gll^Ftr, Gll^Ftr, Gll^Ftr, Gll^Ftr, Gll^Ftr, Gll^Ftr, Gll^Ftr, Gll^Ftr, Gll^Ftr, Gll^Ftr, Gll^Ftr, Gll^Ftr
Gg, Gg, Gg, Gg, Gg, Gg, Gg, Gg, Gll^Ftr, Gg, Gg, Gg, Gg, Gg, Gg, Gg, Gg, Gg, Gll^Ftr, Gll^Ftr, Gll^Ftr, Gll^Ftr, Gll^Ftr, Gll^Ftr, Gll^Ftr, Gll^Ftr, Gll^Ftr, Gg, Gll^Ftr, Gg, Gll^Ftr, Gg, Gll^Ftr, Gll^Ftr, Gll^Ftr, Gll^Ftr, Gll^Ftr, Gll^Ftr, Gll^Ftr, Ww, Wo, Ww, Gll^Ftr, Gll^Ftr, Gll^Ftr, Gll^Ftr, Gll^Ftr, Gll^Ftr, Gll^Ftr, Gll^Ftr, Gll^Ftr, Gll^Ftr, Gll^Ftr, Gll^Ftr, Gll^Ftr, Gll^Ftr, Gll^Ftr
Gg, Gg, Gg, Gg, Gll^Ftr, Gll^Ftr, Gll^Ftr, Gll^Ftr, Gll^Ftr, Gll^Ftr, Gll^Ftr, Gll^Ftr, Gll^Ftr, Gll^Ftr, Gll^Ftr, Gg, Gll^Ftr, Gll^Ftr, Gll^Ftr, Gll^Ftr, Gll^Ftr, Gll^Ftr, Gll^Ftr, Gll^Ftr, Gll^Ftr, Gll^Ftr, Gll^Ftr, Gll^Ftr, Gll^Ftr, Gll^Ftr, Gll^Ftr, Gll^Ftr, Gll^Ftr, Gll^Ftr, Gll^Ftr, Gll^Ftr, Gll^Ftr, Gll^Ftr, Gll^Ftr, Ww, Ww, Ww, Ww, Gll^Ftr, Gll^Ftr, Gll^Ftr, Gll^Ftr, Gll^Ftr, Gll^Ftr, Gll^Ftr, Gll^Ftr, Gll^Ftr, Gll^Ftr, Gll^Ftr, Gll^Ftr, Gll^Ftr, Gll^Ftr
Gg, Gg, Gg, Gg, Gll^Ftr, Gll^Ftr, Gll^Ftr, Gll^Ftr, Gll^Ftr, Gll^Ftr, Gll^Ftr, Gll^Ftr, Gll^Ftr, Gll^Ftr, Gll^Ftr, Gll^Ftr, Gll^Ftr, Gll^Ftr, Gll^Ftr, Gll^Ftr, Gll^Ftr, Gll^Ftr, Gll^Ftr, Gll^Ftr, Gll^Ftr, Gll^Ftr, Gll^Ftr, Gll^Ftr, Gll^Ftr, Gll^Ftr, Gll^Ftr, Gll^Ftr, Gll^Ftr, Gll^Ftr, Gll^Ftr, Gll^Ftr, Gll^Ftr, Gll^Ftr, Gll^Ftr, Gll^Ftr, Ww, Ww, Ww, Gll^Ftr, Gll^Ftr, Gll^Ftr, Gll^Ftr, Gll^Ftr, Gll^Ftr, Gll^Ftr, Gll^Ftr, Gll^Ftr, Gll^Ftr, Gll^Ftr, Gll^Ftr, Gll^Ftr, Gll^Ftr
Gll^Ftr, Gll^Ftr, Gll^Ftr, Gll^Ftr, Gll^Ftr, Gll^Ftr, Gll^Ftr, Gll^Ftr, Gll^Ftr, Gll^Ftr, Gll^Ftr, Gll^Ftr, Gll^Ftr, Gll^Ftr, Gll^Ftr, Gll^Ftr, Gll^Ftr, Gll^Ftr, Gll^Ftr, Gll^Ftr, Gll^Ftr, Gll^Ftr, Md, Gll^Ftr, Gll^Ftr, Gll^Ftr, Gll^Ftr, Gll^Ftr, Gll^Ftr, Gll^Ftr, Gll^Ftr, Gll^Ftr, Gll^Ftr, Gll^Ftr, Gll^Ftr, Gll^Ftr, Gll^Ftr, Gll^Ftr, Gll^Ftr, Gll^Ftr, Md, Ww, Wo, Ww, Ww, Gll^Ftr, Gll^Ftr, Gll^Ftr, Gll^Ftr, Gll^Ftr, Gll^Ftr, Gll^Ftr, Gll^Ftr, Gll^Ftr, Gll^Ftr, Gll^Ftr, Gll^Ftr
Gll^Ftr, Gll^Ftr, Gll^Ftr, Gll^Ftr, Gll^Ftr, Gll^Ftr, Gll^Ftr, Gll^Ftr, Gll^Ftr, Gll^Ftr, Md, Gll^Ftr, Gll^Ftr, Gll^Ftr, Gll^Ftr, Gll^Ftr, Gll^Ftr, Gll^Ftr, Gll^Ftr, Gll^Ftr, Md, Md, Md, Md, Md, Gll^Ftr, Gll^Ftr, Gll^Ftr, Md, Gll^Ftr, Gll^Ftr, Gll^Ftr, Md, Gll^Ftr, Md, Md, Md, Gll^Ftr, Md, Md, Md, Md, Ww, Wo, Ww, Gll^Ftr, Gll^Ftr, Gll^Ftr, Ww, Gll^Ftr, Gll^Ftr, Gll^Ftr, Md, Gll^Ftr, Md, Gll^Ftr, Md
Gll^Ftr, Gll^Ftr, Gll^Ftr, Gll^Ftr, Gll^Ftr, Gll^Ftr, Gll^Ftr, Gll^Ftr, Md, Md, Md, Md, Mm, Gll^Ftr, Gll^Ftr, Gll^Ftr, Md, Md, Md, Md, Md, Md, Md, Md, Md, Gll^Ftr, Gll^Ftr, Gll^Ftr, Md, Md, Md, Md, Md, Md, Md, Md, Md, Md, Md, Md, Md, Md, Md, Ww, Ww, Ww, Ww, Ww, Wo, Ww, Md, Md, Md, Md, Md, Md, Md
Gll^Ftr, Gll^Ftr, Gll^Ftr, Gll^Ftr, Gll^Ftr, Gll^Ftr, Md, Md, Md, Md, Md, Md, Md, Md, Md, Gll^Ftr, Md, Md, Md, Md, Md, Md, Md, Md, Md, Gll^Ftr, Uue, Xue, Xue, Md, Md, Md, Md, Md, Md, Md, Md, Md, Md, Md, Md, Md, Md, Md, Md, Ww, Ww, Ww, Wo, Xue, Md, Md, Md, Md, Md, Md, Md
Gll^Ftr, Gll^Ftr, Gll^Ftr, Gll^Ftr, Gll^Ftr, Gll^Ftr, Md, Md, Md, Md, Md, Md, Md, Md, Md, Md, Md, Md, Md, Md, Md, Md, Md, Md, Md, Xue, Uue, Xue, Xue, Xue, Md, Md, Md, Md, Md, Md, Md, Md, Md, Md, Md, Md, Md, Md, Md, Xue, Xue, Xue, Wo, Xue, Xue, Xue, Md, Md, Md, Md, Md
Gll^Ftr, Gll^Ftr, Gg, Gll^Ftr, Gll^Ftr, Gll^Ftr, Md, Md, Md, Md, Md, Md, Md, Md, Md, Md, Md, Md, Md, Md, Md, Md, Mm, Md, Xue, Xue, Uue, Uue, Xue, Xue, Md, Md, Md, Md, Md, Md, Md, Md, Md, Md, Md, Md, Md, Md, Md, Md, Md, Xue, Xue, Wo, Wo, Xue, Md, Md, Md, Md, Md
