Mm, Mm, Mm, Mm, Mm, Mm, Mm, Mm, Mm, Mm, Mm, Mm, Hh^Fms, Hh^Fms, Gs^Fms, Gs^Fms, Gs^Fms, Gs^Fms, Gs, Gg, Gg, Gg, Gg, Gg, Gg, Gg, Gg, Gg, Gg, Gg, Gg, Gs, Gs^Fms, Gs^Fms, Gs^Fms, Gs^Fms, Gs^Fms, Gs^Fms, Gs^Fms, Gs^Fms, Gs^Fms, Gs^Fms, Gs^Fms, Gs^Fms, Gs^Fms, Gs^Fms, Gs^Fms, Gs^Fms, Gs^Fms, Gs, Gg, Gg, Gg, Gg, Gs, Gg, Gs, Gg, Gg, Gg, Gg, Gg, Gg, Gs, Gs, Gg, Gg, Gg, Gg, Gg, Gg, Rp, Rp, Rp, Gg, Gg, Gg, Gg, Gg, Gg, Gg, Gg, Gg, Gg, Gs, Gg, Gg, Gg, Gg, Gg, Gg, Gg
Mm, Mm, Mm, Mm, Mm, Mm, Mm, Mm, Mm, Mm, Mm, Mm, Hh^Fms, Hh^Fms, Gs^Fms, Gs^Fms, Gs^Fms, Gs^Fms, Gs, Gg, Gg, Gg, Gg, Gg, Gg, Gg, Gg, Gg, Gg, Gg, Gg, Gs, Gs^Fms, Gs^Fms, Gs^Fms, Gs^Fms, Gs^Fms, Gs^Fms, Gs^Fms, Gs^Fms, Gs^Fms, Gs^Fms, Gs^Vl, Gs^Fms, Gs^Fms, Gs^Fms, Gs^Fms, Gs^Fms, Gs^Fms, Gs, Gg, Gg, Gg, Gg, Gg, Gs, Gs, Gg, Gs, Gs, Gg, Gg, Gg, Gg, Gs, Gg, Gg, Gg, Gs, Gs, Gs, Rp, Rp, Rp, Gs, Gs, Gg, Gg, Gg, Gs, Gg, Gg, Gg, Gs, Gg, Gg, Gg, Gs, Gs, Gs, Gs, Gg
Mm, Mm, Mm, Mm, Mm, Mm, Mm, Mm, Mm, Mm, Mm, Mm, Hh^Fms, Hh^Fms, Gs^Fms, Gs^Fms, Gs, Gs, Gg, Gs^Vc, Gg, Gg, Gg^Es, Gg, Gg, Gg, Gg, Gg, Gg, Gg, Gg, Gs, Gs^Fms, Gs^Fms, Gs^Vl, Gs^Fms, Gs^Fms, Gs^Fms, Gs^Fms, Gs^Fms, Gs^Fms, Gs^Fms, Gs^Fms, Gs^Fms, Gs^Fms, Gs^Fms, Gs^Fms, Gs^Fms, Gs^Fms, Gs, Gg, Gg, Gg, Gg, Gg, Gg, Gg^Es, Gs, Gg, Gg, Gg, Gg, Gg, Gg, Hh, Gg, Gg, Gs, Gg, Gs, Gg, Rp, Rp, Rp, Gg, Gg, Gs, Gs, Gg, Gs, Gg, Gg, Gs, Gg, Gg, Gg^Es, Gg^Es, Gs, Gg, Gs, Gs, Gg
Mm, Mm, Mm, Mm, Mm, Mm, Mm, Mm, Mm, Mm, Mm, Mm, Gs^Fms, Gs^Fms, Gs, Gs, Gg, Gg, Gg, Gg, Gg, Gg, Gg^Es, Gg, Gg, Gg, Gg, Gg, Gg^Es, Gg, Gg, Gs, Gs^Fms, Gs^Fms, Gs^Fms, Gs^Fms, Gs^Fms, Gs^Fms, Gs^Fms, Gs^Fms, Gs, Gs^Fms, Gs^Fms, Gs^Fms, Gs^Fms, Gs^Fms, Gs^Fms, Gs^Fms, Gs^Fms, Gs, Gg, Gg, Gg, Gg, Gg, Gg, Gg, Gg, Gg, Gg, Gg, Gg, Hh, Hh, Hh, Hh, Hh, Gg, Gg, Gg, Gg, Rp, Rp, Rp, Gg, Gg, Gg, Gg, Gg, Gs, Gg, Gs, Gs, Gg, Gs^Vl, Gs, Gs, Gg, Gg, Gs, Gg, Gg
Mm, Mm, Mm, Mm, Mm, Mm, Mm, Mm, Mm, Mm, Mm, Gs^Fms, Gs^Fms, Gs, Gg, Gg, Ce, Ce, Ce, Gg, Gg, Gg, Gg, Gg, Gg, Gg, Gg, Gg, Gg^Es, Gg, Gg, Gs, Gs, Gs^Fms, Gs^Fms, Gs^Fms, Gs, Gs, Gs, Gs, Gs, Gs, Gs, Gs^Fms, Gs^Fms, Gs^Fms, Gs^Fms, Gs^Fms, Gs, Gs, Gg, Gg, Gs, Gg, Gs, Gg, Gg, Gg, Hh, Hh, Hh, Hh, Hh^Fp, Hh^Fp, Hh^Fp, Hh, Hh, Hh, Gg, Gg, Rp, Rp, Rp, Rp, Gg, Gg, Gg, Gg, Gg^Es, Gs, Gg, Gs, Gg, Gg, Gg, Gs, Gg, Gg, Gs, Gg, Gg, Gg
Mm, Mm, Mm, Mm, Mm, Mm, Mm, Mm, Mm, Mm, Mm, Gs^Fms, Gs, Gs, Gg, Ce, Ce, 3 Ke, Ce, Ce, Gg, Gg, Gg, Gg, Gg, Gg, Gg, Gg, Gg^Es, Gg, Gg, Gg, Gg, Gs, Gs, Gs, Gg, Gs, Gg, Gs, Gg, Gg, Gs, Gs, Gs, Gs^Fms, Gs, Gs, Gg, Gg, Gs, Gs, Gs^Fms, Gs, Gs, Gg, Gg, Gg, Hh^Vhh, Hh, Hh^Fp, Hh^Fp, Mm, Mm, Mm, Hh^Fp, Hh, Hh, Rp, Rp, Rp, Rp, Rp, Rp, Gs, Gg, Gg, Gg, Gs, Gg, Gg, Gs, Gg, Gg, Gg, Gg, Gg, Gs, Gg, Gg, Gg, Gg
Mm, Mm, Mm, Mm, Mm, Mm, Mm, Mm, Mm, Mm, Hh^Vhh, Gs^Fms, Gs^Fms, Gs, Gg, Ce, Ce, Ce, Ce, Ce, Gg, Gg, Gs^Vl, Gg, Gg, Gg, Gg, Gg^Es, Gg, Gg, Gg, Gg, Gg, Gg, Gg, Gs, Gs, Gs, Gs, Gs, Gs, Gs, Gs, Gs, Gg, Gs, Gg, Gg, Gg, Gg, Gs, Gs^Fms, Gs^Fms, Gs^Fms, Gs^Fms, Gs, Gs, Gg, Gg, Hh, Hh^Fp, Mm, Mm, Mm, Mm, Hh^Fp, Rp, Rp, Rp, Rp, Rp, Rp, Gs^Fms, Gs, Gs, Gs, Gg, Gs, Gg, Gg, Gs, Gs, Gg, Gg, Gg, Gg, Gg^Es, Gg^Es, Gg, Gg, Gg, Gg
Mm, Mm, Mm, Mm, Mm, Mm, Mm, Mm, Mm, Hh^Fms, Hh^Fms, Gs^Fms, Gs^Fms, Gs, Gg, Gg, Gg, Ce, Gg, Gg, Gg, Gg, Gg, Gg, Gg, Gg, Gg^Es, Gg, Gg, Gg, Gg, Gg, Gs, Gg, Gs, Gs, Gs, Gs, Gs^Fms, Gs, Gs^Fms, Gs, Gs^Fms, Gs, Gs, Gg, Gg, Gg^Es, Gg, Gg, Gs, Gs^Fms, Gs^Fms, Gs^Fms, Gs^Fms, Gs^Fms, Gs, Gg, Gg, Gg, Hh^Fp, Mm, Mm, Mm, Mm, Hh^Fp, Rp, Rp, Rp, Rp, Hh, Gs^Fms, Gs^Fms, Gs^Fms, Gs^Fms, Gs, Gs, Gg, Gg, Gg, Gs, Gg, Gg, Gg, Gg, Gg^Es, Gg, Gs, Gg, Gs, Gg, Gg
Mm, Mm, Mm, Mm, Mm, Mm, Mm, Mm, Gs^Fms, Hh^Fms, Gs^Fms, Gs^Fms, Gs^Fms, Gs, Gg, Gg, Gs^Vc, Gg^Es, Gg, Gg^Es, Gg, Gg, Gg^Es, Gg, Gg, Gg, Gg^Es, Gg, Gg, Gg, Gs, Gs, Gs^Fms, Gs, Gs, Gs, Gs, Gs^Fms, Gs^Fms, Gs^Fms, Gs^Fms, Gs^Fms, Gs^Fms, Gs^Fms, Gs^Fms, Gs, Gs, Gg, Gg, Gg, Gs, Gs^Fms, Gs^Fms, Gs^Vl, Gs^Fms, Gs^Fms, Gs, Gg, Gg, Hh, Hh, Hh^Fp, Hh^Fp, Mm, Hh^Fp, Hh^Fp, Rp, Rp, Rp, Hh, Hh^Fp, Hh, Hh, Gs^Fms, Gs^Fms, Gs^Fms, Gs, Gg, Gg, Gg, Gg, Gs, Gg, Gs, Gs, Gs, Gs, Gg, Gg, Gg, Gg, Gg
Mm, Mm, Mm, Mm, Gs^Fms, Mm, Gs^Fms, Gs^Fms, Ww, Gs^Fms, Gs^Fms, Gs^Fms, Gs^Fms, Gs, Gg, Gg, Gg, Gg, Gg, Gg, Gg, Gg^Es, Gg, Gg, Gg, Gg, Gg, Gg, Gg, Gg, Gs, Gs^Fms, Gs^Fms, Gs, Gs^Fms, Gs^Fms, Gs^Fms, Gs^Fms, Gs^Fms, Gs^Fms, Gs^Fms, Gs^Fms, Gs^Fms, Gs^Fms, Gs^Fms, Gs^Fms, Gs^Fms, Gs, Gs, Gg, Gs, Gs^Fms, Gs^Fms, Gs^Fms, Gs^Fms, Gs^Fms, Gs, Gg, Gg, Hh, Hh, Hh^Fp, Hh, Hh^Fp, Hh, Hh, Rp, Rp, Rp, Hh, Hh^Fp, Hh^Fp, Hh, Hh, Gs^Fms, Gs^Fms, Gs, Gg, Gg, Gs^Vl, Gg, Gg, Gg, Gg, Gs, Gg, Gg, Gs, Gg, Gg, Gg, Gg
Mm, Mm, Wo, Wo, Wo, Wo, Wo, Ww, Ww, Gs^Fms, Gs^Fms, Gs^Fms, Gs, Gs, Gg, Gg, Gg, Gg, Gg, Gg, Gg, Gg, Gg, Gg, Gg, Gg, Gg, Gg, Gg, Gg, Gs, Gs^Fms, Gs^Fms, Gs^Fms, Gs^Fms, Gs^Fms, Gs^Fms, Gs^Fms, Gs^Fms, Gs^Fms, Gs^Fms, Gs^Fms, Gs^Fms, Gs^Fms, Gs^Fms, Gs^Fms, Gs^Fms, Gs, Gs, Gg, Gg, Gs, Gs, Gs^Fms, Gs, Gs, Gg, Gg, Gg, Hh, Hh, Hh, Hh, Hh, Rp, Rp, Rp, Rp, Rp, Hh, Hh, Hh^Fp, Hh, Hh, Gs^Fms, Gs^Fms, Gs, Gg, Gg, Gg, Gg, Gg^Es, Gs, Gs, Gg, Gg, Gg, Gg, Gg, Gg, Gg, Gg
Wo, Wo, Wo, Wo, Wo, Wo, Wo, Wo, Wo, Wo, Wo, Wo, Ww, Gg, Gg, Gg, Gg, Gg, Gg, Gg, Gg, Gg, Gg, Gg, Ww, Gg, Gg, Gg, Gg, Gs, Gs^Fms, Gs^Fms, Gs^Fms, Gs^Fms, Gs^Fms, Gs^Fms, Gs^Fms, Gs^Fms, Ww, Ww, Ww, Ww, Ww, Gs^Fms, Gs^Fms, Gs^Fms, Gs^Fms, Gs^Fms, Gs^Fms, Gs, Gs, Gg, Gg, Gs, Gs, Gs, Gg, Gg, Gg, Hh, Hh, Hh, Rp, Rp, Rp, Rp, Rp, Rp, Hh, Hh, Hh, Hh, Gs^Fms, Gs^Fms, Gs^Fms, Gs^Fms, Gs, Gg, Gg, Gg, Gs, Gs^Es, Gg, Gg, Gg, Gg, Gg, Gg, Gg, Gg, Gg, Gg
Wo, Wo, Mm, Gs^Fms, Mm, Wo, Ds, Wo, Ww, Wo, Wo, Gs^Fms, Gs^Fms, Ww, Ww, Gg, Ww, Ww, Ww, Gg, Gg, Gg, Ww, Ww, Wo, Ww, Ww, Gg, Gs, Gs, Gs^Fms, Gs^Fms, Gs^Fms, Gs^Fms, Gs^Fms, Gs^Fms, Ww, Gs^Fms, Ww, Ww, Wo, Ww, Ww, Ww, Gs^Fms, Gs^Fms, Gs^Fms, Gs^Fms, Gs^Fms, Gs^Fms, Gs, Gg, Gg, Gg, Gg, Gg, Gg^Es, Gg, Gg, Gg, Rp, Rp, Rp, Rp, Rp, Rp, Hh, Hh, Hh^Fp, Hh, Hh, Gs^Fms, Gs^Fms, Gs^Fms, Gs^Fms, Gs, Gg, Gg, Gg, Gg, Gg, Gg, Gg, Gg^Es, Gs, Gg, Gg, Gg, Gg, Gg, Gg, Gg
Mm, Mm, Mm, Mm, Mm, Mm, Gs^Fms, Ds, Ds, Ww, Wo, Gs^Fms, Gs^Fms, Ww, Wo, Ww, Ww, Ww^Vm, Wo, Ww, Ww, Gg, Ww, Wo, Ww, Wo, Ww, Gs, Gs, Gs^Fms, Gs^Fms, Gs^Fms, Gs^Fms, Gs^Fms, Ww, Ww, Ww, Ww, Wo, Wo, Ww^Vm, Wo, Wo, Ww, Ww, Gs^Fms, Gs^Fms, Gs^Fms, Gs^Fms, Gs^Fms, Gs, Gg, Gg, Gg, Gg, Gg, Gg, Gg^Es, Gg, Gg, Rp, Rp, Rp, Rp, Hh, Hh, Hh^Fp, Hh^Fp, Hh^Fp, Hh, Hh, Gs^Fms, Gs^Fms, Gs^Fms, Gs, Gs, Gg, Gg, Gs, Gs, Gg, Gg, Gg, Gs, Gg^Es, Gg, Gg, Gg, Gs, Gg, Gg, Gg
Mm, Mm, Mm, Mm, Mm, Mm, Gs^Fms, Gs^Fms, Ds, Wo, Wo, Gs^Fms, Ww, Ww, Ww, Ww, Gg, Ww, Ww, Ww, Ww, Ww, Ww, Ww, Gg, Ww, Ww, Ww, Ww, Gs^Fms, Gs^Fms, Gs^Fms, Ww, Gs^Fms, Ww, Ww, Wo, Wo, Ww, Wo, Wo, Wo, Wo, Ww, Ww, Ww, Gs^Fms, Gs^Fms, Gs^Fms, Gs^Fms, Gs, Gs, Gg, Gg, Gg, Gg, Gg, Gg, Gg, Gg, Rp, Rp, Rp, Gs^Fms, Hh, Hh, Hh, Hh^Fp, Hh, Hh, Hh, Gs^Fms, Gs^Fms, Gs, Gg, Gg, Gg, Gg, Gg, Gg, Gg, Gg, Gg, Gg, Gg, Gg^Es, Gg, Gg, Gg, Gg, Gg, Gg
Mm, Mm, Mm, Mm, Mm, Mm, Mm, Gs^Fms, Ds, Wo, Wo, Ww, Ww, Ww, Gg, Gg, Gg, Gg, Gg, Gg, Gg, Ww, Gg, Gg, Gg, Gg, Gg, Ww, Ww, Ww, Ww, Ww, Ww, Ww, Wo, Wo, Ww, Ww, Ww, Ww, Ww, Wo, Wo, Wo, Ww, Ww, Gs^Fms, Gs^Fms, Gs^Fms, Gs^Fms, Gs, Gg, Gg^Es, Gg, Gg, Gg, Gg, Gg, Gg, Gg, Rp, Rp, Rp, Gs^Fms, Gs^Fms, Hh, Hh, Hh, Hh, Hh, Gs^Fms, Gs^Fms, Gs^Fms, Gs, Gg, Gg, Gg, Gs, Gg, Gg, Gs, Gg, Gg, Gg, Gg, Gg, Gs, Gg, Gg, Gg, Gg, Gg
Mm, Mm, Mm, Mm, Mm, Mm, Mm, Mm, Ww, Wo, Ww, Ww, Gs^Fms, Gs, Gg, Gg, Gs, Gs, Gs, Gg, Gs, Gg, Gg, Gg, Gg, Gg, Gs, Gs, Gs, Ww, Ww, Ww, Wo, Wo, Ww, Ww, Gs^Fms, Ds, Gs^Fms, Ww, Ww, Ww, Wo, Wo, Ww, Gs^Fms, Gs^Fms, Gs^Fms, Gs, Gs, Gs, Gg, Gg, Gg, Gg, Gg, Gg, Gg, Gg, Gg, Rp, Rp, Rp, Gll, Gs^Fms, Gs^Fms, Gs^Fms, Hh, Gs^Fms, Gs^Fms, Gs^Fms, Gs^Fms, Gs^Fms, Gs, Gg, Gg, Gg, Gs, Gg, Gg, Gs, Gg, Gg, Gg, Gs, Gs, Gs, Gg, Gg, Gg, Gg, Gg
Mm, Mm, Mm, Mm, Mm, Mm, Mm, Mm, Ww, Wo, Gs^Fms, Gs^Fms, Gs^Fms, Gs, Gg, Gg, Gg, Gg, Gg, Gs, Gg, Gg, Gg, Gg, Gg, Gs, Gs^Fms, Gs^Fms, Gs^Fms, Gs, Ds, Ww, Wo, Wo, Ww, Ww, Gs^Fms, Gs^Fms, Gs^Fms, Gs, Ww, Wo, Wo, Wo, Ww, Gs^Fms, Gs^Fms, Gs^Fms, Gs, Gs, Gg, Gg, Gg, Gg, Gg, Gg, Gg, Gg, Gg, Gg, Rp, Rp, Rp, Gs^Fms, Gs^Fms, Gs^Fms, Gs^Fms, Gs^Fms, Gs^Fms, Gs^Fms, Gs^Fms, Gs, Gs, Gs, Gg, Gg, Gg, Gg, Gg, Gg, Gs, Gs, Gs, Gs, Gs^Fms, Gs^Fms, Gs^Fms, Gs, Gs, Gg, Gg, Gg
Mm, Mm, Mm, Mm, Mm, Mm, Mm, Mm, Ww, Wo, Gs^Fms, Gs^Fms, Gs^Fms, Gs, Gs, Gg, Gg, Gg, Gs^Vc, Gg, Gg, Gg, Gg, Gg, Gs, Gs, Gs^Fms, Gs^Fms, Gs^Fms, Ds, Ww, Ww, Wo, Wo, Ww, Ww, Gs^Fms, Gs^Vl, Gs^Fms, Gs, Ww^Bw\, Wo, Wo, Ww, Ww, Gs^Fms, Gs^Fms, Gs, Gg, Gg, Gg, Gg, Gg, Gg, Gg, Gg, Cv, Gg, Gg, Gg, Rp, Rp, Rp, Gs^Fms, Gs^Fms, Gs^Fms, Cv, Gs^Fms, Gs^Fms, Gs^Fms, Cv, Gs, Gg, Gg, Gg, Gg, Gg, Gg, Gg, Gs, Gs^Fms, Gs^Fms, Gs^Fms, Gs^Fms, Gs^Fms, Gs^Fms, Gs^Fms, Gs^Fms, Gs, Gg, Gg, Gg
Mm, Mm, Mm, Mm, Wo, Gs^Fms, Wo, Ww, Wo, Wo, Gs^Fms, Gs^Fms, Gs^Fms, Gs^Fms, Gs, Gg, Gg, Gg, Gs, Gg, Gg, Gg, Gs, Gs, Gs^Fms, Gs^Fms, Gs^Fms, Gs^Fms, Gs^Fms, Ww, Ww, Ww, Wo, Wo, Wo, Ww, Ww, Gs^Fms, Ww, Ww, Ww, Wo^Bw\, Ww^Bw\, Ww, Ww, Gs, Gs, Gs, Gg, Gg, Gg, Gg, Gg, Gg, Cv, Cv, Rr, Cv, Cv, Cv, Rp, Rp, Rp, Cv, Cv, Cv, Rr, Cv, Cv, Cv, Rr, Cv, Cv, Gg, Gg, Gg, Gg, Gg, Gg, Gs, Gs^Fms, Gs^Fms, Gs^Fms, Gs^Fms, Gs^Fms, Gs^Fms, Gs^Fms, Gs^Fms, Gs, Gg, Gg, Gg
Mm, Mm, Wo, Wo, Wo, Wo, Wo, Wo, Wo, Wo, Gs^Fms, Gs^Fms, Gs^Fms, Gs^Fms, Gs, Gg, Gg, Gg, Ce, Ce, Ce, Gg, Gs, Gs, Gs^Fms, Gs^Fms, Gs^Fms, Gs^Fms, Gs^Fms, Gs^Fms, Gs^Fms, Ww, Ww, Wo, Wo, Ww, Ww, Ww, Wo, Wo, Wo, Wo, Ww, Ww^Bw\, Ww^Bw\, Gg, Gg, Gs, Gg, Gg, Gg, Gg, Gg, Cv, Rr, Rr, Rr^Vhc, Rr, Cv, Rr, Rr, Rr, Rr, Rr, Cv, Rr, Rr, Rr, Rr, Rr, Rr^Vhc, Rr, Rr, Cv, Gg, Gg, Gg, Gg, Gg, Gs, Gs^Fms, Gs^Fms, Gs^Fms, Gs^Fms, Gs^Fms, Gs^Fms, Gs^Fms, Gs^Fms, Gs, Gg, Gg, Gg
Wo, Wo, Wo, Wo, Gs^Fms, Ww, Mm, Wo, Hh^Fms, Gs^Fms, Gs^Fms, Gs^Fms, Gs^Fms, Gs^Fms, Gs, Gg, Gg, Ce, Ce, 5 Ke, Ce, Ce, Gs, Gs^Fms, Gs^Fms, Gs^Fms, Gs^Fms, Gs^Fms, Gs^Fms, Gs^Fms, Gs^Fms, Ww, Ww, Ww, Ww, Wo, Wo, Wo, Ww^Vm, Wo, Wo, Wo, Ww, Ww, Ww, Gg, Gg, Gg, Gs^Vc, Gg, Gg, Gg, Gg, Cv, Rr, Rr, Rr, Rr, Rr, Rr, Rr, Rr, Rr, Rr, Rr, Rr, Rr, Rr, Rr^Vhc, Rr, Rr, Rr, Rr, Cv, Gg, Gg, Gg, Gg, Gg, Gs, Gs^Fms, Gs^Fms, Gs^Fms, Gs^Fms, Gs^Fms, Gs^Fms, Gs^Fms, Gs^Fms, Gs, Gg, Gg, Gg
Wo, Wo, Gs^Fms, Gs^Fms, Mm, Mm, Mm, Mm, Mm, Hh^Fms, Gs^Fms, Gs^Fms, Gs, Gs, Gg, Gg, Gg, Ce, Ce, Ce, Ce, Ce, Gs, Gs^Fms, Gs^Fms, Gs^Fms, Gs^Fms, Gs^Vl, Gs^Fms, Gs^Fms, Gs^Fms, Ww, Ww, Ww, Ww, Wo, Wo, Wo, Wo, Wo, Wo, Ww, Ww, Ww, Ww, Gg, Gg, Gg, Gg, Gg, Gg, Gg, Cv, Cv, Rr, Rr, Rr, Rr, Rr, Rr, Rr^Vhc, Rr, Rr^Vhc, Rr, Rr, Rr^Vhc, Rr, Rr, Rr, Rr, Rr, Rr, Rr, Cv, Gg, Gg, Gg, Gg, Gg, Gs, Gs^Fms, Gs^Fms, Gs^Fms, Gs^Fms, Gs^Fms, Gs^Fms, Gs, Gs, Gs, Gs, Gs, Gg
Mm, Mm, Mm, Mm, Mm, Mm, Mm, Mm, Mm, Hh^Fms, Gs^Fms, Gs^Fms, Gs, Gg, Gg, Gg, Gs, Gg, Gg, Ce, Gg, Gg, Gg, Gs, Gs^Fms, Gs^Fms, Gs^Fms, Gs^Fms, Gs^Fms, Gs^Fms, Gs^Fms, Gs^Fms, Gs^Fms, Ww, Ww, Ww, Ww, Wo, Wo, Wo, Ww, Ww, Ds, Ww, Ds, Gg, Gg, Gg, Gg, Gg, Gg, Gg, Cv, Rr, Rr, Rr^Vhc, Rr, Rr^Vhc, Rr, Rr, Rr, Rr, Rr, Rr, Rr, Rr, Rr, Rr, Rr, Rr^Vhc, Rr, Rr^Vhc, Rr, Cv, Cv, Gg, Gg, Gg, Gg, Gs, Gs, Gs^Fms, Gs, Gs^Fms, Gs^Fms, Gs^Fms, Gs, Gg, Gs, Gg, Gg, Gg
Mm, Mm, Mm, Mm, Mm, Mm, Mm, Mm, Mm, Hh^Fms, Gs, Gs, Gg, Gg, Gg, Gg, Gs^Vc, Gs, Gg, Gg, Gs, Gg, Gs, Gs, Gs^Fms, Gs^Fms, Gs^Fms, Gs^Fms, Gs^Fms, Gs^Vl, Gs^Fms, Gs^Fms, Gs^Fms, Gs^Fms, Ds, Ww, Ww, Wo, Wo, Ww, Wo, Ww, Ww, Ds, Ds, Gg, Gg, Gg, Gg, Gg, Gg, Gg, Cv, Rr, Rr, Rr, Rr, Rr, Rr, Rr, Rr, Rr, Rr, Rr, Rr, Rr, Rr, Rr, Rr, Rr, Rr, Rr, Rr^Vhc, Rr, Cv, Gg, Gg, Gg, Gg, Gg, Gg, Gs, Gg, Gs, Gs, Gs, Gs, Gs, Gs, Gs, Gs, Gg
Mm, Mm, Mm, Mm, Mm, Mm, Mm, Mm, Hh, Hh, Gg, Gs, Gg, Gg, Gg, Gg, Gg, Gg, Gg, Gg, Gs, Gg, Gs, Gs^Fms, Gs^Fms, Gs^Fms, Gs^Fms, Gs^Fms, Gs^Fms, Gs^Fms, Gs^Fms, Gs^Fms, Gs^Fms, Gs^Fms, Ww, Ww, Wo, Wo, Wo, Wo, Wo, Wo, Ww, Ds, Ww, Gg, Gg, Gg, Gg, Gg, Rp, Rp, Rp, Rr, Rr, Rr, Cv, Cv, Cv, Kv, Rrc, Rr, Rrc, Kv, Cv, Cv, Cv, Cv, Cv, Rr, Rr, Rr, Rr, Rr, Cv, Gg, Gg, Gg, Gs, Gg, Gg, Gg, Gg, Gg, Gs, Gs, Gg, Gs, Gg, Gs, Gg, Gg
Mm, Mm, Mm, Mm, Mm, Mm, Mm, Hh, Gg, Gg, Gg, Gg, Gg, Gg, Gg, Gg, Gs, Gg, Gg, Gs, Gg, Gg, Gs, Gs^Fms, Gs^Fms, Gs^Fms, Gs^Fms, Gs^Fms, Gs^Fms, Gs^Fms, Gs^Fms, Gs^Fms, Gs^Fms, Ww, Ww, Wo, Wo, Wo, Wo, Wo, Wo, Ww, Wo, Ww, Ww, Ww, Gg, Gg, Rp, Rp, Rp, Rp, Rp, Rr, Rr, 1 Kv, Cv, Cv, Gg^Fet, Gg^Fet, Rrc, Rrc, Rrc, Rrc, Rrc, Gg^Fet, Gg^Fet, Cv, Cv, Kv, Rr, Rr, Rr, Gs^Fms, Cv, Gg, Gg, Gg, Gg, Gs, Gs, Gg, Gs, Gg, Gg, Gg, Gs, Gg, Gg, Gg, Gg, Gg
Mm, Mm, Mm, Mm, Mm, Mm, Hh, Hh^Vhh, Gs, Gs, Gg, Gg, Gg, Gg, Gg, Gg, Gg, Gs, Gs, Gg, Gg, Gg, Gg, Gs, Gs, Gs, Gs, Gs^Fms, Gs^Fms, Gs^Fms, Gs^Fms, Gs^Fms, Gs^Fms, Ww, Ww, Wo, Ww, Wo, Ww, Wo, Wo, Wo, Wo, Wo, Wo, Ww, Gg, Gg, Rp, Rp, Gs^Fms, Gs^Fms, Cv, Rr, Rr, Cv, Cv, Cv, Gg^Fet, Rrc, Gg^Ve, Rrc, Rrc, Gg^Ve, Rrc, Rrc, Gg^Fet, Cv, Cv, Cv, Rr, Rr^Vhc, Rr, Gs^Fms, Cv, Gs^Fms, Gg, Gg, Gg, Gg, Gg, Gg, Gs, Gg, Gg, Gg, Gg, Gs, Gs, Gs, Gg, Gg
Mm, Mm, Mm, Mm, Hh^Fms, Hh^Fms, Gg, Gg, Gs, Gg, Gg, Gg, Hh, Hh, Hh, Gg, Gg, Gs, Gg, Gg, Gg, Gg, Gg, Gg, Gs^Vc, Gs, Gs, Gs, Gs, Gs, Gs, Gs^Fms, Gs, Ww, Ww, Ww, Ww, Ww, Ww, Ww, Ww, Ww, Ww, Ww, Ww, Ww, Gg, Gg, Rp, Rp, Gs^Fms, Cv, Rr, Rr, Rr, Kv, Cv, Cv, Rrc, Rrc, Rrc, Rrc, Cv, Rrc, Rrc, Rrc, Rrc, Cv, Cv, Kv, Rr, Rr, Rr, Cv, Gs^Fms, Gs^Fms, Gg, Gg, Gg, Gg, Gg, Gg, Gg, Gg, Gg, Gg, Gg, Gg, Gg, Gg, Gg, Gg
Mm, Mm, Mm, Mm, Hh^Fms, Hh^Fms, Gg, Gs, Gg, Gg, Hh, Hh, Hh^Fp, Hh^Fp, Hh^Fp, Hh, Gg, Gg, Gg, Gg, Gg, Gg, Rp, Rp, Rp, Rp, Rp, Rp, Rp, Rp, Rp, Rp, Rp, Rp, Rp, Rp, Rp, Rp, Rp, Rp, Rp, Rp, Rp, Rp, Rp, Rp, Rp, Rp, Rp, Rp, Rp, Cv, Gs^Fms, Rr, Rr, Rr, Rrc, Rrc, Rrc, Rrc, Gg^Fet, Cv, 2 Kv, Cv, Gg^Fet, Rrc, Rrc, Rrc, Rr, Rr, Rr, Rr^Vhc, Rr, Cv, Rp, Rp, Rp, Rp, Rp, Rp, Rp, Rp, Rp, Rp, Rp, Rp, Rp, Rp, Rp, Rp, Rp, Gg
Mm, Mm, Mm, Mm, Hh^Fms, Hh^Fms, Gg, Gs, Gg, Gg, Hh, Hh, Hh^Fp, Hh^Vhh, Hh^Fp, Hh, Hh, Gg, Gg, Gg, Rp, Rp, Rp, Rp, Rp, Rp, Rp, Rp, Rp, Rp, Rp, Rp, Rp, Rp, Rp, Rp, Rp, Rp, Rp, Rp, Rp, Rp, Rp, Rp, Rp, Rp, Rp, Rp, Rp, Rp, Rp, Kv, Gs^Fms, Rr, Rr, Rr, Rrc, Rrc, Rrc, Rrc, Gg^Fet, Cv, Kv, Cv, Gg^Fet, Rrc, Rrc, Rrc, Rr, Rr, Rr, Rr, Rr, Rp, Rp, Rp, Rp, Rp, Rp, Rp, Rp, Rp, Rp, Rp, Rp, Rp, Rp, Rp, Rp, Rp, Rp, Rp
Rp, Rp, Rp, Rp, Rp, Rp, Rp, Rp, Rp, Rp, Rp, Hh, Hh, Hh^Fp, Hh, Hh, Hh, Gg, Rp, Rp, Rp, Rp, Rp, Rp, Gg, Rp, Gg, Rp, Gg, Rp, Gg, Rp, Gg, Rp, Gg, Rp, Gg, Rp, Gg, Rp, Gg, Rp, Gg, Rp, Gg, Rp, Gg, Rp, Rp, Rp, Gs^Fms, Cv, Rr, Rr, Rr, Rr, Cv, Rrc, Rrc, Rrc, Rrc, Cv, Cv, Cv, Rrc, Rrc, Rrc, Rrc, Cv, Rr, Rr, Rr, Rr, Cv, Gs^Fms, Rp, Gg, Rp, Gg, Rp, Gg, Rp, Gg, Rp, Gg, Rp, Gg, Rp, Gg, Rp, Rp, Rp
Rp, Rp, Rp, Rp, Rp, Rp, Rp, Rp, Rp, Rp, Rp, Rp, Rp, Hh, Hh, Hh, Rp, Rp, Rp, Rp, Rp, Rp, Gg, Gg, Gg, Gg, Gg, Gg, Gg, Gg, Gg, Gg, Gg, Gg, Gg, Gg, Gg, Gg, Gg, Gg, Gs, Gg, Gs, Gs, Gg, Gg, Gg, Gg, Rp, Rp, Gs^Fms, Cv, Cv, Rr, Rr, Kv, Cv, Cv, Rrc, Rrc, Gg^Ve, Rrc, Rrc, Rrc, Gg^Ve, Rrc, Rrc, Cv, Cv, Kv, Rr, Rr^Vhc, Rr, Cv, Cv, Gs^Fms, Gg, Gg, Gg, Gg, Gg, Gg, Gg, Gg, Gg, Gg, Gg, Gg, Gg, Gg, Gg, Rp
Hh^Fms, Rp, Hh^Fms, Rp, Hh^Fms, Rp, Gs^Fms, Gs^Fms, Gs^Fms, Rp, Rp, Rp, Rp, Rp, Rp, Rp, Rp, Rp, Rp, Rp, Gg, Gg, Gg, Gg, Gg, Gg, Gg, Gg, Gg, Gg, Gg, Gg, Gg, Gg, Gg, Gg, Gg, Gg, Gg^Es, Gs, Gs^Fms, Gs^Fms, Gs^Fms, Gs^Fms, Gs^Fms, Gs, Gg, Gg, Rp, Rp, Rp, Gs^Fms, Rp, Rr, Rr, Cv, Cv, Cv, Gg^Fet, Rrc, Rrc, Rrc, Rrc, Rrc, Rrc, Rrc, Gg^Fet, Cv, Cv, Cv, Rr, Rr, Rr, Gs^Fms, Cv, Gs^Fms, Gg, Gg, Gg, Gg, Gg, Gg, Gs, Gs, Gs, Gg, Gg, Gg, Gg, Gg, Gg, Gg
Hh^Fms, Hh^Fms, Hh^Fms, Hh^Fms, Hh^Fms, Gs^Fms, Hh^Fms, Gs^Fms, Gs^Fms, Gs^Fms, Gs^Fms, Rp, Rp, Rp, Rp, Rp, Rp, Rp, Gg, Gg, Gg, Gg, Gg, Gg, Gg, Gg, Gg, Gg, Gs, Gg, Gg, Gg, Gg, Gg, Gg, Gg, Gg^Es, Gs, Gs, Gs, Gs^Fms, Gs^Fms, Gs^Fms, Gll, Gs^Fms, Gs^Fms, Gg, Gg, Gg, Rp, Rp, Rp, Rp, Rr, Rr, Cv, Cv, Cv, Gg^Fet, Rrc, Rrc, Rrc, Rrc, Rrc, Rrc, Rrc, Gg^Fet, Cv, Cv, Cv, Rr, Rr, Rr, Gs^Fms, Cv, Gg, Gg, Gg, Gg, Gg, Gs, Gs, Gs, Gg, Gg, Gs, Gg, Gg, Gg, Gg, Gg, Gg
Mm, Hh^Fms, Hh^Fms, Hh^Fms, Hh^Fms, Hh^Fms, Hh^Fms, Hh^Fms, Gs^Fms, Gs^Fms, Gs^Fms, Gs^Fms, Gs, Rp, Rp, Rp, Gg, Gg, Gg, Gg, Gg, Gg, Gg, Gg, Gs, Gs, Gs, Gs, Gs^Fms, Gs, Gs, Gg, Gg, Gg, Gg, Gg^Es, Gg, Gg, Gs, Gg, Gs, Gs, Gg, Gs^Fms, Gg, Gs, Gg, Gg, Gg, Gg, Gg, Rp, Rp, Rr, Rr, Kv, Cv, Gg^Fet, Cv, Gg^Fet, Kv, Rrc, Rr, Rrc, Kv, Gg^Fet, Cv, Gg^Fet, Cv, Kv, Rr, Rr, Rr, Rr, Cv, Gg, Gg, Gg, Gs, Gg, Gs, Gg, Gg, Gs, Gs, Gs, Gs^Vl, Gg, Gg, Gg, Gg, Gg
Mm, Mm, Mm, Hh^Fms, Mm, Hh^Fms, Hh^Fms, Hh^Fms, Gs^Fms, Gs^Fms, Gs^Fms, Gs^Fms, Gs^Fms, Gs, Gs, Gg, Gg, Gg, Gg, Gg, Gg, Gg, Gg, Gg, Gs, Gs, Gs^Fms, Gs^Fms, Gs^Fms, Gs^Fms, Gs^Fms, Gs, Gs, Gg, Gg, Gg, Gg, Gs, Gg, Gg, Gg, Gg, Gg, Gg, Gg, Gs, Gg, Gg, Gg, Gg, Gg, Gg, Cv, Rr, Rr^Vhc, Rr, Rr, Cv, Rr, Cv, Rr, Rr, Rr, Rr, Rr, Cv, Rr, Cv, Rr, Rr, Rr, Rr, Rr, Cv, Gg, Gg, Gg, Gs, Gg, Gg, Gg, Gg, Gs, Gs, Gg, Gg, Gg, Gg, Gg^Es, Gg, Gg, Gg
Mm, Mm, Mm, Mm, Mm, Mm, Mm, Hh^Fms, Gs^Fms, Gs^Fms, Gs^Fms, Gs^Fms, Gs^Fms, Gs^Fms, Gs^Fms, Gs, Gg, Gg, Gg, Gg, Gg, Gg, Gs, Gs, Gs^Fms, Gs^Fms, Gs^Fms, Gs^Fms, Gs^Fms, Gs^Fms, Gs^Fms, Gs^Fms, Gs, Gg, Gg, Gg, Gg, Gg, Gg, Gg, Gg, Gg, Gg, Gg, Gg, Gg, Gg, Gg, Gg, Gg, Gg, Gg, Cv, Rr, Rr, Rr, Rr, Rr, Rr, Rr, Rr, Rr, Rr, Rr, Rr, Rr, Rr, Rr, Rr, Rr, Rr, Rr^Vhc, Rr, Cv, Gg, Gg, Gg, Gg, Gg, Gg, Gg, Gs, Gg, Gg, Gg, Gg, Gs, Gs^Es, Gs, Gg, Gg, Gg
Mm, Mm, Mm, Mm, Mm, Mm, Mm, Mm, Gs^Fms, Gs^Fms, Gs^Fms, Gs^Fms, Gs^Fms, Gs^Fms, Gs^Fms, Gs, Gg, Gg, Gg, Gg, Gs, Gs, Gs^Fms, Gs, Gs^Fms, Gs^Fms, Gs^Fms, Gs^Vl, Gs^Fms, Gs^Fms, Gs^Fms, Gs^Fms, Gs, Gs, Gg, Gg, Gs, Gg, Gs, Gg, Gg, Gg, Gs, Gs, Gs, Gg, Gg, Gg, Gg, Gg, Gs, Gs, Cv, Rr, Rr, Rr, Rr, Rr, Rr^Vhc, Rr, Rr, Rr, Rr^Vhc, Rr, Rr^Vhc, Rr, Rr, Rr, Rr, Rr^Vhc, Rr, Rr, Rr, Cv, Gg, Gg, Gg, Gg, Gg, Gg, Gg, Gg, Gg, Gg, Gg, Gs, Gs, Gg, Gg, Gs, Gg, Gg
Mm, Mm, Mm, Mm, Mm, Mm, Mm, Mm, Mm, Mm, Mm, Gs^Fms, Gs^Fms, Gs^Fms, Gs^Fms, Gs, Gs, Gg, Gg, Gs, Gs^Fms, Gs^Fms, Gs^Fms, Gs^Fms, Gs^Fms, Gs^Fms, Gs^Fms, Gs^Fms, Gs^Fms, Gs^Fms, Gs^Fms, Gs^Fms, Gs, Gs, Gs, Gs, Gs^Fms, Gs, Gs^Fms, Gs, Gs, Gg, Gs, Gs, Gg, Gs, Gs, Gs, Gg, Gs, Gs^Fms, Gs^Fms, Gs^Fms, Cv, Rr, Rr^Vhc, Rr, Rr, Rr, Rr, Rr^Vhc, Rr, Rr, Rr, Rr, Rr, Rr^Vhc, Rr, Rr, Rr, Rr, Rr^Vhc, Rr, Cv, Gg, Gg, Gg, Gg, Gg, Gs, Gg, Gg, Gg, Gg^Es, Gs, Gs, Gg, Gs, Gg, Gg, Gg, Gg
Mm, Mm, Mm, Mm, Mm, Mm, Mm, Mm, Mm, Mm, Mm, Gs^Fms, Gs^Fms, Gs^Fms, Gs^Fms, Gs^Fms, Gs^Fms, Gs, Gg, Gs, Gs^Fms, Gs^Fms, Gs^Fms, Gs^Fms, Gs^Fms, Gs^Fms, Gs^Fms, Gs^Fms, Gs^Fms, Gs^Fms, Gs, Gs, Gg, Gs, Gs^Fms, Gs^Fms, Gs^Fms, Gs^Fms, Gs^Fms, Gs^Fms, Gs^Fms, Gs, Gs, Gs, Gg, Gs, Gg, Gs, Gs, Gs, Gs^Fms, Gs^Fms, Gs^Fms, Cv, Rr, Rr, Rr^Vhc, Rr, Cv, Rr, Rr, Rr, Rr, Rr, Cv, Rr, Rr, Rr, Rr, Rr, Rr^Vhc, Rr, Rr, Cv, Gs, Gg, Gg, Gg, Gg, Gg, Gs, Gs, Gs, Gg, Gs, Gg, Gs, Gg, Gs, Gg, Gg, Gg
Mm, Mm, Mm, Mm, Mm, Mm, Mm, Mm, Mm, Mm, Mm, Gs^Fms, Gs^Fms, Gs^Fms, Gs^Fms, Gs^Fms, Gs^Fms, Gs, Gg, Gs, Gs^Fms, Gs^Fms, Gs^Fms, Gs^Vl, Gs^Fms, Gs^Fms, Gs^Fms, Gs^Fms, Gs, Gs, Gs, Gg, Gs, Gs, Gs^Fms, Gs^Fms, Gs^Fms, Gs^Fms, Gs^Fms, Gs^Fms, Gs^Fms, Gs^Fms, Gs, Gs, Gg, Gg, Gg, Gs, Gs^Fms, Gs^Fms, Gs^Fms, Gs^Fms, Gs^Fms, Cv, Cv, Rr, Rr, Rr, Cv, Rr, Rp, Rr, Rp, Rr, Cv, Rr, Rr, Rr, Cv, Rr, Rr, Rr, Cv, Cv, Gs^Fms, Gs, Gg, Gg, Gg, Gg, Gg^Es, Gg, Gg, Gs, Gs, Gs, Gg, Gs, Gg, Gs, Gg, Gg
Mm, Mm, Mm, Mm, Mm, Mm, Mm, Mm, Mm, Mm, Mm, Gs^Fms, Gs^Fms, Gs^Fms, Gs^Fms, Gs^Fms, Gs, Gs, Gg, Gs, Gs^Fms, Gs^Fms, Gs^Fms, Gs^Fms, Gs^Fms, Gs^Fms, Gs, Gs, Gg, Gs, Gs, Gs, Gs^Fms, Gs^Fms, Gs^Fms, Gs^Fms, Gs^Fms, Gs^Fms, Gs^Fms, Gs^Fms, Gs^Fms, Gs^Fms, Gs^Fms, Gs, Gg, Gg, Gg, Gs, Gs^Fms, Gs^Fms, Gs^Fms, Gs^Fms, Gs^Fms, Gs^Fms, Gs^Fms, Cv, Cv, Cv, Gg, Cv, Rp, Rp, Rp, Cv, Gs, Cv, Cv, Cv, Gs^Fms, Cv, Cv, Cv, Gs^Fms, Gs^Fms, Gs^Fms, Gs, Gs, Gg, Gg, Gs, Gs^Es, Gg, Gs, Gg, Gg, Gg, Gg, Gg, Gg, Gg, Gg, Gg
Mm, Mm, Mm, Mm, Mm, Mm, Mm, Mm, Mm, Mm, Mm, Mm, Gs^Fms, Gs^Fms, Gs^Fms, Gs, Gg, Gs, Gs, Gs, Gs, Gs^Fms, Gs^Fms, Gs^Fms, Gs^Fms, Gs^Fms, Gs, Gg, Gg, Gg, Gs, Gs^Fms, Gs^Fms, Gs^Fms, Gs^Fms, Gs^Fms, Gs^Vl, Gs^Fms, Gs^Fms, Gs^Fms, Gs^Fms, Gs^Fms, Gs^Fms, Gs, Gg, Gg, Gg, Gs, Gs^Fms, Gs^Fms, Gs^Fms, Gs^Fms, Gs^Fms, Gs^Fms, Gs^Fms, Gs^Fms, Gs^Fms, Gs, Gg, Gg, Rp, Rp, Rp, Gs, Gs^Fms, Gs^Fms, Gs^Fms, Gs^Fms, Gs^Fms, Gs^Fms, Gs^Fms, Gs^Fms, Gs^Fms, Gs^Fms, Gs^Fms, Gs^Fms, Gs, Gg, Gg, Gs, Gg, Gg, Gg, Gg, Gg, Gg, Gs, Gg, Gg, Gg, Gg, Gg
Mm, Mm, Mm, Mm, Mm, Mm, Mm, Mm, Mm, Mm, Mm, Mm, Gs^Fms, Gs^Fms, Gs^Fms, Gs, Gs, Gg, Gg, Gg, Gg, Gs, Gs, Gs^Fms, Gs, Gs^Efm, Gg, Gg, Gg, Gg, Gs, Gs^Fms, Gs^Fms, Gs^Fms, Gs^Fms, Gs^Fms, Gs^Fms, Gs^Fms, Gs^Fms, Gs^Fms, Gs^Fms, Gs^Fms, Gs^Fms, Gs, Gg, Gg, Gg, Gs, Gs^Fms, Gs^Fms, Gs^Fms, Gs^Fms, Gs^Fms, Gs^Fms, Gs^Fms, Gs^Fms, Gs^Fms, Gs, Gg, Gg, Rp, Rp, Rp, Gs, Gs^Fms, Gs^Fms, Gs^Fms, Gs^Fms, Gs^Fms, Gs^Fms, Gs^Fms, Gs^Fms, Gs^Fms, Gs^Fms, Gs^Fms, Gs, Gg, Gg, Gg, Gg, Gg, Gg^Es, Gg, Gg, Gs, Gs, Gg, Gs, Gs, Gg, Gg, Gg
Mm, Mm, Mm, Mm, Mm, Mm, Mm, Mm, Mm, Mm, Hh^Fms, Hh^Fms, Gs^Fms, Gs^Fms, Gs^Fms, Gs^Fms, Gs, Gg, Gg, Gg^Es, Gg, Gg, Gg, Gs, Gg, Gg^Efm, Gs^Efm, Gs, Gs, Gg, Gs, Gs^Fms, Gs^Fms, Gs^Fms, Gs^Fms, Gs^Fms, Gs^Fms, Gs^Fms, Gs^Fms, Gs^Fms, Gs^Fms, Gs^Fms, Gs^Fms, Gs, Gs, Gs, Gs, Gs, Gs, Gs^Fms, Gs, Gs, Gs, Gs^Fms, Gs^Fms, Gs^Fms, Gs, Gs, Gg, Gg, Rp, Rp, Rp, Gs, Gs, Gs^Fms, Gs, Gs, Gs, Gs, Gs^Fms, Gs^Fms, Gs^Fms, Gs^Fms, Gs^Fms, Gs, Gg, Gg, Gg, Gg, Gg, Gs, Gs, Gs, Gg, Gg, Gg, Gg, Gg, Gs, Gg, Gg
Mm, Mm, Mm, Mm, Mm, Mm, Mm, Mm, Mm, Mm, Hh^Fms, Hh^Fms, Hh^Fms, Gs^Fms, Gs^Fms, Gs^Fms, Gs, Gg, Gg, Gg, Gs, Gs, Gg, Gg^Efm, Gg, Gg, Gg, Gg, Gg, Gg, Gs, Gs^Fms, Gs^Fms, Gs^Fms, Gs^Fms, Gs^Fms, Gs^Fms, Gs^Fms, Gs^Fms, Gs^Fms, Gs^Fms, Gs^Fms, Gs^Fms, Gs, Gs, Gg, Gg, Gs, Gs, Gs, Gg, Gs, Gg, Gs, Gs, Gs, Gg, Gg, Gg, Gg, Rp, Rp, Rp, Gs, Gs, Gs, Gg, Gg, Gg, Gs, Gs, Gs^Fms, Gs^Fms, Gs^Fms, Gs, Gs, Gg, Gg, Gs^Eff, Gg^Eff, Gg^Eff, Gs, Gg, Gg, Gg, Gg, Gg, Gg, Gg, Gs, Gg, Gg
Mm, Mm, Mm, Mm, Mm, Mm, Hh^Fms, Mm, Hh^Fms, Hh^Fms, Hh^Fms, Hh^Fms, Gs^Fms, Gs^Fms, Gs^Fms, Gs^Fms, Gs, Gg, Gg, Gs^Es, Gg^Es, Gg, Gg^Efm, Gs^Vc, Gs^Efm, Gs, Gg, Gg^Efm, Gg, Gs, Gs, Gs^Fms, Gs^Fms, Gs^Fms, Gs^Fms, Gs^Fms, Gs^Fms, Gs^Fms, Gs^Fms, Gs^Fms, Gs^Fms, Gs^Fms, Gs, Gs, Gs, Gg, Gg, Gs, Gg, Gg, Gs, Gs, Gs, Gg, Gg, Gg, Gg, Gg, Gg, Gg, Rp, Rp, Rp, Gs, Gg, Gs, Gs, Gg, Gg, Gg, Gg, Gs, Gs, Gs, Gg, Gg, Gg, Gs^Eff, Re^Gvs, Re^Gvs, Re^Gvs, Gg, Gg, Gg, Gs, Gg, Gg, Gs, Gg^Es, Gg^Es, Gg, Gg
Hh^Fms, Mm, Hh^Fms, Mm, Hh^Fms, Hh^Fms, Hh^Fms, Hh^Fms, Hh^Fms, Hh^Fms, Hh^Fms, Gs^Fms, Gs^Fms, Gs^Fms, Gs, Gs, Gg, Gg, Gg, Gs, Gs^Efm, Gg^Efm, Gs^Efm, Gg, Gs, Gg, Gs, Gg, Gs, Gs, Gg, Gs, Gs, Gs^Fms, Gs^Fms, Gs^Fms, Gs^Fms, Gs^Fms, Gs^Fms, Gs^Fms, Gs, Gs, Gg, Gs^Es, Gs^Es, Gs, Gs, Gg, Gg, Gs, Gs^Fms, Gs^Fms, Gs^Fms, Gs, Gs, Gg, Gs, Gg, Gg, Gg, Rp, Rp, Rp, Gs, Gs, Gs, Gg, Gg, Gg, Gg, Gg, Gs, Gg, Gg, Gg^Eff, Gg, Re^Gvs, Re^Gvs, Re^Gvs, Re^Gvs, Re^Gvs, Gg^Wm, Re^Gvs, Gs^Eff, Gs^Eff, Gg, Gg^Es, Gg, Gs, Gg, Gg, Gg
Hh^Fms, Hh^Fms, Hh^Fms, Hh^Fms, Hh^Fms, Hh^Fms, Hh^Fms, Hh^Fms, Gs^Fms, Hh^Fms, Gs^Fms, Gs^Fms, Gs^Fms, Gs^Fms, Gs^Fms, Gs, Gg, Gg, Gg^Efm, Gg, Gg, Gg, Gg, Gg, Gg, Gg, Gg^Es, Gs^Es, Gg^Efm, Gg, Gg^Efm, Gg, Gg, Gs, Gs, Gs^Fms, Gs, Gs, Gs, Gs, Gg, Gg, Gg, Gs, Gg, Gg, Gg, Gs, Gs, Gs, Gs^Fms, Gs^Fms, Gs^Fms, Gs^Fms, Gs^Fms, Gs, Gs^Fms, Gs, Gs, Gg, Rp, Rp, Rp, Gg, Gg, Gs, Gg, Gg, Gs, Gs^Vc, Gs, Gs, Gg^Eff, Gg^Eff, Re^Gvs, Re^Gvs, Gs^Vh, Re^Gvs, Re^Gvs, Re^Gvs, Re^Gvs, Re^Gvs, Gg, Gg^Eff, Re^Gvs, Gg^Eff, Gg^Eff, Gs^Es, Gs, Gg, Gg, Gg
Hh^Fms, Hh^Fms, Hh^Fms, Hh^Fms, Hh^Fms, Hh^Fms, Hh^Fms, Gs^Fms, Gs^Fms, Gs^Fms, Gs^Fms, Gs^Fms, Gs^Fms, Gs^Fms, Gs^Fms, Gs, Gg, Gg^Efm, Gg, Gg, Gg, Gg, Gs, Gg, Gs, Gg, Gg, Gg, Gg^Efm, Gg, Gs^Vc, Gg^Efm, Gg^Efm, Gg, Gs, Gs, Gs, Gs, Gs, Gg, Gg, Gg, Gg, Gg, Gg, Gg, Gg, Gs, Gs, Gs^Fms, Gs^Fms, Gs^Fms, Gs^Fms, Gs^Fms, Gs^Fms, Gs^Fms, Gs^Fms, Gs^Fms, Gs, Gg, Rp, Rp, Rp, Gg, Gg, Gs, Gs, Gs, Gg, Gg, Gs, Gs, Gg, Gg^Eff, Gg, Re^Gvs, Re^Gvs, Re^Gvs, Re^Gvs, Re^Gvs, Gg, Gg, Re^Gvs, Re^Gvs, Re^Gvs, Gg^Wm, Re^Gvs, Gg^Eff, Gg^Eff, Gs, Gg, Gg
Hh^Fms, Hh^Fms, Hh^Fms, Hh^Fms, Hh^Fms, Hh^Fms, Hh^Fms, Gs^Fms, Gs^Fms, Gs^Fms, Gs^Fms, Gs^Fms, Gs^Fms, Gs^Fms, Gs^Fms, Gs, Gs, Gs, Gs, Gg, Gs, Gs, Gs^Fms, Gs, Gs, Gg, Gg, Gg, Gg^Efm, Gg^Efm, Gg^Efm, Gg^Efm, Gg^Efm, Gg, Gg, Gs, Gs, Gs, Gg, Gs, Gs, Gs, Gs, Gg, Gs, Gg, Gs, Gs, Gs, Gs^Fms, Gs^Fms, Gs^Fms, Gs^Fms, Gs^Fms, Gs^Fms, Gs^Fms, Gs^Fms, Gs^Fms, Gs, Gg, Rp, Rp, Rp, Gg, Gg, Gg, Gg, Gs, Gs, Gg, Gs, Gg, Gg, Gg, Gg, Gg, Gg^Eff, Re^Gvs, Gg^Eff, Gs^Eff, Re^Gvs, Re^Gvs, Re^Gvs, Re^Gvs, Re^Gvs, Re^Gvs, Gs^Eff, Gg^Eff, Re^Gvs, Gs^Eff, Gg^Eff, Gg
Hh^Fms, Hh^Fms, Hh^Fms, Hh^Fms, Hh^Fms, Hh^Fms, Gs^Fms, Gs^Fms, Gs^Fms, Gs^Fms, Gs^Fms, Gs^Fms, Gs^Fms, Gs^Fms, Gs^Fms, Gs^Fms, Gs^Fms, Gs^Fms, Gs^Fms, Gs, Gs^Fms, Gs^Fms, Gs^Fms, Gs^Fms, Gs^Fms, Gs, Gs, Gg, Gg, Gg^Efm, Gg^Efm, Gg^Efm, Gg^Efm, Gg, Gg, Gs, Gg, Gg^Efm, Gg, Gg^Es, Gs, Gg, Gs, Gg, Gg, Gs, Gs, Gs, Gs^Fms, Gs^Fms, Gs^Fms, Gs^Vl, Gs^Fms, Gs^Fms, Gs^Fms, Gs^Fms, Gs^Fms, Gs^Fms, Gs, Gg, Rp, Rp, Rp, Gg, Gs, Gs, Gs, Gs, Gs, Gg, Gs, Gg, Gg, Gg, Gg, Gs, Gg, Gg^Eff, Gg^Eff, Re^Gvs, Re^Gvs, Gs^Vh, Re^Gvs, Re^Gvs, Gg, Gg, Re^Gvs, Re^Gvs, Re^Gvs, Gg^Wm, Gg, Gg^Eff
Gs^Fms, Hh^Fms, Gs^Fms, Gg^Ve, Gs^Fms, Gs^Fms, Gs^Fms, Gs^Fms, Gs^Fms, Gs^Fms, Gs^Fms, Gs^Fms, Gs^Fms, Gs^Fms, Gs^Fms, Gs^Fms, Gs^Fms, Gs^Fms, Gs^Fms, Gs^Fms, Gs^Fms, Gs^Fms, Gs^Fms, Gs^Fms, Gs^Fms, Gs^Fms, Gs^Fms, Gs, Gs, Gg, Gg^Efm, Gg^Efm, Gg^Es, Gg^Efm, Gg^Efm, Gg, Gg, Gg^Efm, Gg, Gg, Gs, Gs, Gs^Fms, Gs, Gs, Gs, Gs^Fms, Gs^Fms, Gs^Fms, Gs^Fms, Gs^Fms, Gs^Fms, Gs^Fms, Gs^Fms, Gs^Fms, Gs^Fms, Gs^Fms, Gs^Fms, Gs^Fms, Gs, Rp, Rp, Rp, Gs, Gs^Fms, Gs^Fms, Gs^Fms, Gs^Fms, Gs^Fms, Gs, Gg, Gg, Gg, Gg, Gg, Gg, Gg, Gg, Gg, Gg^Eff, Gs^Eff, Re^Gvs, Gg^Eff, Gg^Eff, Re^Gvs, Re^Gvs, Re^Gvs, Re^Gvs, Re^Gvs, Re^Gvs, Gg^Eff, Gg^Eff
Gs^Fms, Gs^Fms, Gs^Fms, Gs^Fms, Gs^Fms, Gs^Fms, Gs^Fms, Gs^Fms, Gs^Fms, Gs^Fms, Hh^Fms, Gs^Fms, Hh^Fms, Hh^Fms, Hh^Fms, Hh^Fms, Hh^Fms, Gs^Fms, Gs^Fms, Gs^Fms, Gs^Fms, Gs^Fms, Gs^Fms, Gs^Fms, Gs^Fms, Gs^Fms, Gs^Fms, Gs, Gs, Gg, Gg^Efm, Gg, Gg^Es, Gg, Gg, Gg^Efm, Gg^Efm, Gg, Gg^Efm, Gg, Gs, Gs^Fms, Gs^Fms, Gs^Fms, Gs^Fms, Gs^Fms, Gs^Fms, Gs^Fms, Gs^Fms, Gs^Fms, Gs^Fms, Gs^Fms, Gs^Fms, Gs^Fms, Gs^Fms, Gs^Fms, Gs^Fms, Gs^Fms, Gs^Fms, Gs^Fms, Rp, Rp, Rp, Gs, Gs^Fms, Gs^Fms, Gs^Fms, Gs^Fms, Gs^Fms, Gs, Gg, Gg, Gg, Gg, Gg, Gs, Gs, Gg, Gg, Gs, Gg, Gg^Eff, Gs^Eff, Re^Gvs, Re^Gvs, Gs^Vh, Re^Gvs, Re^Gvs, Gg, Gg, Gg, Gg
Gs^Fms, Gs^Fms, Gs^Fms, Gs^Fms, Gs^Fms, Gs^Fms, Gs^Fms, Gs^Fms, Gs^Fms, Hh^Fms, Hh^Fms, Hh^Fms, Hh^Fms, Hh^Fms, Hh^Fms, Hh^Fms, Hh^Fms, Mm, Mm, Gs^Fms, Gs^Fms, Gs^Fms, Gs^Fms, Gs^Fms, Gs^Fms, Gs^Fms, Gs^Fms, Gs^Fms, Gs, Gg, Gg, Gg, Gs, Gg, Gg, Gg, Gg, Gg^Efm, Gg, Gs, Gs^Fms, Gs^Fms, Gs^Fms, Gs^Fms, Gs^Fms, Gs^Fms, Gs^Fms, Gs^Fms, Gs^Fms, Gs^Fms, Gs^Fms, Gs^Fms, Gs^Fms, Gs^Fms, Gs^Fms, Gs^Fms, Gs^Fms, Gs^Fms, Gs^Fms, Gs^Fms, Rp, Rp, Rp, Gs^Fms, Gs^Fms, Gs^Fms, Gs^Vc, Gs^Fms, Gs^Fms, Gs, Gs, Gg^Es, Gg^Es, Gg, Gg, Gg, Gg, Gg, Gs, Gg, Gg, Gg, Gg, Gg^Eff, Gs^Eff, Re^Gvs, Gg^Eff, Gg^Eff, Gg, Gg, Gg, Gg
Gs^Fms, Gs^Fms, Gs^Fms, Gs^Fms, Gs^Fms, Gs^Fms, Gg^Ve, Gs^Fms, Hh^Fms, Hh^Fms, Hh^Fms, Hh^Fms, Mm, Hh^Fms, Mm, Hh^Fms, Mm, Mm, Mm, Mm, Gs^Fms, Gs^Fms, Gs^Fms, Gs^Fms, Gs^Fms, Gs^Fms, Gs^Fms, Gs^Fms, Gs, Gg, Gg, Gs, Gg, Gg, Gs, Gs, Gg, Gg, Gg, Gs, Gs^Fms, Gs^Fms, Gs^Fms, Gs^Fms, Gs^Fms, Gs^Fms, Gs^Fms, Gs^Fms, Gs^Fms, Gs^Fms, Gs^Fms, Gs^Fms, Gs^Fms, Gs^Fms, Gs^Fms, Gs^Vl, Gs^Fms, Gs^Fms, Gs^Fms, Gs^Fms, Rp, Rp, Rp, Gs^Fms, Gs^Fms, Gs^Fms, Gs^Fms, Gs^Fms, Gs^Fms, Gs^Fms, Gs^Fms, Gs, Gg, Gg, Gg, Gg, Gg, Gs, Gs, Gg, Gg, Gg, Gg, Gs, Gg, Gg^Eff, Gg, Gg, Gs, Gs, Gg, Gg
Gs^Fms, Gs^Fms, Gs^Fms, Gs^Fms, Gs^Fms, Gs^Fms, Gs^Fms, Hh^Fms, Hh^Fms, Hh^Fms, Mm, Mm, Mm, Mm, Mm, Mm, Mm, Mm, Mm, Mm, Mm, Gs^Fms, Mm, Gs^Fms, Gs^Fms, Gs^Fms, Gs^Fms, Gs^Fms, Gs, Gg, Gs, Gs, Gg, Gg, Gg, Gg, Gg, Gs, Gs, Gs, Gs^Fms, Gs^Fms, Gs^Fms, Gs^Fms, Gs^Fms, Gs^Vc, Gs^Fms, Gs^Fms, Gs^Fms, Gs^Fms, Gs^Fms, Gs^Fms, Gs^Fms, Gs^Fms, Gs^Fms, Gs^Fms, Gs^Fms, Gs^Fms, Gs^Fms, Gs^Fms, Rp, Rp, Rp, Gs^Fms, Gs^Fms, Gs^Fms, Gs^Fms, Gs^Fms, Gs^Fms, Gs^Fms, Gs^Fms, Gs, Gs, Gg, Gg, Gg, Gg, Gg, Gs, Gg, Gg, Gg, Gg, Gs, Gg, Gg, Gg, Gg, Gs, Gg, Gg, Gg
Gs^Fms, Gs^Fms, Gs^Fms, Gs^Fms, Gs^Fms, Gs^Fms, Hh^Fms, Hh^Fms, Hh^Fms, Hh^Fms, Mm, Mm, Mm, Mm, Mm, Mm, Mm, Mm, Mm, Mm, Mm, Mm, Mm, Gs^Fms, Gs^Fms, Gs^Fms, Gs^Fms, Gs^Fms, Gs^Fms, Gs, Gs, Gg, Gg, Gg, Gg, Gg^Es, Gg, Gg, Gg, Gs, Gs^Fms, Gs^Fms, Gs^Fms, Gs^Fms, Gs^Fms, Gs^Fms, Gs^Fms, Gs^Fms, Gs^Fms, Gs^Fms, Gs^Fms, Gs^Fms, Gs^Fms, Gs^Fms, Gs^Fms, Gs^Fms, Gs^Fms, Gs^Fms, Gs^Fms, Gs^Fms, Rp, Rp, Rp, Gs^Fms, Gs^Fms, Gs^Fms, Gs^Fms, Gs^Fms, Gs^Fms, Gs^Fms, Gs^Fms, Gs^Fms, Gs, Gg, Gg, Gg, Gg, Gg, Gg, Gg, Gg, Gg, Gs, Gs, Gg, Gg, Gs, Gs, Gg, Gg, Gg, Gg
Gs^Fms, Gg^Ve, Gs^Fms, Gs^Fms, Gs^Fms, Gs^Fms, Hh^Fms, Hh^Fms, Hh^Fms, Mm, Mm, Mm, Mm, Mm, Mm, Mm, Mm, Mm, Mm, Mm, Mm, Mm, Mm, Mm, Gs^Fms, Gs^Fms, Gs^Fms, Gs^Fms, Gs^Fms, Gs^Fms, Gs, Gs, Gg, Gg, Gg, Gg, Gg, Gg, Gg, Gs, Gs^Fms, Gs^Fms, Gs^Fms, Gs^Fms, Gs^Fms, Gs^Fms, Gs^Fms, Gs^Fms, Gs^Fms, Gs^Fms, Gs^Fms, Gs^Fms, Gs^Fms, Gs^Fms, Gs^Fms, Gs^Fms, Gs^Fms, Gs^Fms, Gs^Fms, Gs^Fms, Rp, Rp, Rp, Gs^Fms, Gs^Fms, Gs^Fms, Gs^Fms, Gs^Fms, Gs^Fms, Gs^Fms, Gs^Fms, Gs^Fms, Gs^Fms, Gs, Gg, Gg, Gg, Gs, Gs, Gg, Gg, Gg, Gg, Gs, Gs, Gg, Gg, Gg, Gg, Gg, Gg, Gg
Gs^Fms, Gs^Fms, Gs^Fms, Gs^Fms, Hh^Fms, Hh^Fms, Hh^Fms, Hh^Fms, Mm, Mm, Mm, Mm, Mm, Mm, Mm, Mm, Mm, Mm, Mm, Mm, Mm, Mm, Mm, Mm, Mm, Gs^Fms, Gs^Fms, Gs^Fms, Gs^Fms, Gs^Fms, Gs, Gg, Gg, Gg, Gg, Gg, Gg, Gg, Gg, Gs, Gs^Fms, Gs^Fms, Gs^Fms, Gs^Fms, Gs^Fms, Gs^Fms, Gs^Fms, Gs^Fms, Gs^Fms, Gs^Fms, Gs^Fms, Gs^Fms, Gs^Fms, Gs^Fms, Gs^Fms, Gs^Fms, Gs^Fms, Gs^Fms, Gs^Fms, Gs^Fms, Rp, Rp, Rp, Gs^Fms, Gs^Fms, Gs^Fms, Gs^Fms, Gs^Fms, Gs^Fms, Gs^Fms, Gs^Fms, Gs^Fms, Gs^Fms, Gs, Gg, Gg, Gg, Gg, Gg, Gg, Gg, Gg, Gg, Gg, Gg, Gg, Gg, Gg, Gg, Gg, Gg, Gg
Gs^Fms, Gs^Fms, Gs^Fms, Gs^Fms, Hh^Fms, Hh^Fms, Hh^Fms, Mm, Mm, Mm, Mm, Mm, Mm, Mm, Mm, Mm, Mm, Mm, Mm, Mm, Mm, Mm, Mm, Mm, Mm, Gs^Fms, Gs^Fms, Gs^Fms, Gs^Fms, Gs^Fms, Gs, Gg, Gg, Gg, Gg, Gg, Gg, Gg, Gg, Gs, Gg, Gs^Fms, Gs^Fms, Gs^Fms, Gs^Fms, Gg, Gg, Gs^Fms, Gs^Fms, Gs^Fms, Gs^Fms, Gs^Fms, Gs^Fms, Gs^Fms, Gs^Fms, Gs^Fms, Gs^Fms, Gs^Fms, Gs^Fms, Gs^Fms, Rp, Rp, Rp, Gs^Fms, Gs^Fms, Gs^Fms, Gs^Fms, Gs^Fms, Gs^Fms, Gs^Fms, Gg, Gs^Fms, Gg, Gs, Gg, Gg, Gg, Gg, Gg, Gg, Gg, Gg, Gg, Gg, Gg, Gg, Gg, Gg, Gg, Gg, Gg, Gg
