Hh^Fms, Hh^Fms, Hh^Fms, Hh^Fms, Hh^Fms, Hh^Fms, Hh^Fms, Hh^Fms, Hh^Fms, Hh^Fms, Hh^Fms, Gs^Fms, Gs^Fms, Gs^Fms, Gs^Fms, Gs, Gg, Gg, Gg, Gg, Gg, Gg, Gg, Gg, Gg, Gg, Gg, Gg, Gg, Gg, Gg, Gg, Gg, Gg, Gg, Gg, Gg, Gg, Gs, Gs, Gg, Gg, Rp, Rp, Rp, Gg, Gg, Gg, Gg, Gg, Gg, Gg, Gs, Gs, Gg, Gg, Gg, Gg, Gg, Gg, Gg, Gs, Gs^Fms, Gs^Fms, Hh^Fms, Hh^Fms, Hh^Fms, Hh^Fms, Hh^Fms, Hh^Fms, Hh^Fms, Hh^Fms
Hh^Fms, Hh^Fms, Hh^Fms, Hh^Fms, Hh^Fms, Hh^Fms, Hh^Fms, Hh^Fms, Hh^Fms, Hh^Fms, Hh^Fms, Gs^Fms, Gs^Fms, Gs^Fms, Gs^Fms, Gs, Gg, Gg, Gg, Gg, Gg, Gg, Gs, Gg, Gs, Gg, Gs, Gg, Gs, Gg, Gs, Gg, Gg, Gg, Gs, Gg, Gg, Gg, Gg, Gs, Gs, Gg, Rp, Rp, Rp, Gg, Gg, Gg, Gg, Gg, Gg, Gg, Gs, Gg, Gs, Gg, Gg, Gs, Gs, Gg, Gs, Gs, Gs^Fms, Gs^Fms, Hh^Fms, Hh^Fms, Hh^Fms, Hh^Fms, Hh^Fms, Hh^Fms, Hh^Fms, Hh^Fms
Hh^Fms, Hh^Fms, Hh^Fms, Hh^Fms, Hh^Fms, Hh^Fms, Hh^Fms, Hh^Fms, Gs^Fms, Hh^Fms, Gs^Fms, Gs^Fms, Gs^Fms, Gs^Fms, Gs^Fms, Gs, Gg, Gg, Gg, Gg, Gs, Gg, Gg, Gs, Gs, Gg, Gg, Gs, Gg, Gs, Gs, Gg, Gs, Gs, Gs^Fms, Gs, Gs, Gg, Gg, Gg, Gg, Gg, Rp, Rp, Rp, Gg, Gg, Gg, Gg, Gg, Gs, Gg, Gg, Gg, Gs, Gg, Gg, Gg, Gs, Gg, Gs, Gs^Fms, Gs^Fms, Gs^Fms, Gs^Fms, Hh^Fms, Hh^Fms, Hh^Fms, Hh^Fms, Hh^Fms, Hh^Fms, Hh^Fms
Hh^Fms, Hh^Fms, Hh^Fms, Hh^Fms, Hh^Fms, Hh^Fms, Hh^Fms, Hh^Fms, Gs^Fms, Gs^Fms, Gs^Fms, Gs^Fms, Gs^Fms, Gs^Fms, Gs, Gs, Gg, Gg, Gg, Gs, Gs, Gg, Gg, Gg, Gg, Gg, Gg, Gg, Gg, Gg, Gg, Gs, Gs^Fms, Gs^Fms, Gs^Fms, Gs^Fms, Gs^Fms, Gs, Gs, Gg, Gg, Gg, Rp, Rp, Rp, Gg, Gg, Gg, Gg, Gs, Gg, Gs, Gg, Gs, Gg, Gg, Gg, Gg, Gg, Gg, Gs, Gs^Fms, Gs^Fms, Gs^Fms, Gs^Fms, Hh^Fms, Hh^Fms, Hh^Fms, Hh^Fms, Hh^Fms, Hh^Fms, Hh^Fms
Hh^Fms, Hh^Fms, Hh^Fms, Hh^Fms, Hh^Fms, Hh^Fms, Hh^Fms, Gs^Fms, Gs^Fms, Gs^Fms, Gs^Fms, Gs^Fms, Gs, Gs, Gg, Gg, Gg, Gg, Gg, Gg, Gg, Gg, Gs, Gg, Gs, Gg, Gg, Gg, Gs, Gg, Gg, Gs, Gs^Fms, Gs^Fms, Gs^Fms, Gs^Fms, Gs^Fms, Gs^Fms, Gs^Fms, Gs, Gs, Gg, Rp, Rp, Rp, Gg, Gg, Gs, Gs, Gg, Gg, Gg, Gg, Gg, Gg, Gg, Gg, Gg, Gg, Gg, Gg, Gs, Gs^Fms, Gs^Fms, Gs^Fms, Gs^Fms, Gs^Fms, Hh^Fms, Hh^Fms, Hh^Fms, Hh^Fms, Hh^Fms
Hh^Fms, Hh^Fms, Hh^Fms, Hh^Fms, Hh^Fms, Hh^Fms, Gs^Fms, Gs^Fms, Gs^Fms, Gs^Fms, Gs^Fms, Gs, Gs, Gg, Gg, Gg, Gg, Gs, Gs, Gs, Gs, Gs, Gg, Gs, Gg, Gs, Gs, Gg, Gg, Gg, Gs, Gs, Gs^Fms, Gs^Fms, Hh, Hh, Hh, Gs^Fms, Gs^Fms, Gs^Fms, Gs, Gs, Rp, Rp, Rp, Gg, Gg, Gs, Gg, Gg, Gg, Gg, Gs, Gg, Gs, Gs, Gs, Gs, Gg, Gg, Gg, Gs, Gs^Fms, Gs^Fms, Gs^Fms, Gs^Fms, Gs^Fms, Hh^Fms, Hh^Fms, Hh^Fms, Hh^Fms, Hh^Fms
Hh^Fms, Hh^Fms, Hh^Fms, Hh^Fms, Gs^Fms, Gs^Fms, Gs^Fms, Gs^Fms, Gs^Fms, Gs^Fms, Gs, Gs, Gg, Gg, Gg, Gg, Gg, Gg, Gs, Gg, Gs, Gs, Gg, Gg, Gg, Gg, Gs, Gg, Gg, Gg, Gs, Gs^Fms, Gs^Fms, Gs^Fms, Hh, Hh^Fms, Hh^Fms, Hh, Hh, Gs^Fms, Gs^Fms, Gs, Rp, Rp, Rp, Gg, Gg, Gg, Gg, Gg, Gg, Gg, Gs, Gg, Gg, Gs, Gs, Gs, Gg, Gg, Gs, Gs, Gs, Gs^Fms, Gs^Fms, Gs^Fms, Gs^Fms, Gs^Fms, Gs^Fms, Hh^Fms, Hh^Fms, Hh^Fms
Gs^Fms, Hh^Fms, Gs^Fms, Gs^Fms, Gs^Fms, Gs^Fms, Gs, Gs, Gs, Gs, Gs, Gs, Gg, Gg, Gg, Gs, Gg, Gg, Gg, Gg, Gg, Gg, Gg, Gg, Gg, Gg, Gg, Gg, Gg, Gg, Gs, Gs, Gs^Fms, Gs^Fms, Hh, Hh^Fms, Hh^Fms, Hh^Fms, Hh, Gs^Fms, Gs^Fms, Gs^Fms, Rp, Rp, Rp, Gg, Gg, Gg, Gg, Gg, Ce, Ce, Ce, Gg, Gs, Gg, Gs, Gg, Gg, Gg, Gs, Gg, Gs, Gs^Fms, Gs^Fms, Gs^Fms, Gs^Fms, Gs^Fms, Gs^Fms, Gs^Fms, Gs^Fms, Gs^Fms
Gs^Fms, Gs^Fms, Gs^Fms, Gs^Fms, Gs, Gs, Gg, Gg, Gg, Gs, Gg, Gs, Gg, Gg, Gs, Gs, Gg, Gg, Gs, Gg, Gg, Gg, Gg, Gg, Gs, Gg, Gs, Gs, Gg, Gg, Gs, Gs^Fms, Gs^Fms, Gs^Fms, Gs^Fms, Hh, Hh, Hh, Gs^Fms, Gs^Fms, Gs^Fms, Gs^Fms, Rp, Rp, Rp, Gg, Gg, Gg, Gg, Ce, Ce, 6 Ke, Ce, Ce, Gg, Gs, Gg, Gg, Gg, Gs, Gg, Gg, Gs, Gs^Fms, Gs^Fms, Gs^Fms, Gs^Fms, Gs^Fms, Gs^Fms, Gs^Fms, Gs^Fms, Gs^Fms
Gs^Fms, Gs^Fms, Gs^Fms, Gs, Gg, Gg, Gg, Gg, Gs, Gg, Gg, Gg, Gg, Gg, Gg, Gs, Gg, Gs, Gs, Gg, Gg, Gs, Gg, Gg, Gs, Gg, Gg, Gs, Gs, Gg, Gg, Gs, Gs, Gs, Gs, Gs^Fms, Gs^Fms, Gs^Fms, Gs^Fms, Gs^Fms, Rp, Rp, Rp, Rp, Rp, Gg, Gg, Gg, Gg, Ce, Ce, Ce, Ce, Ce, Gg, Gg, Gg, Gg, Gg, Gg, Gg, Gg, Gg, Gs, Gs, Gs, Gs, Gs, Gs, Gs^Fms, Gs, Gs^Fms
Gs^Fms, Gs^Fms, Gs, Gs, Gg, Gg, Gg, Gg, Gs, Gg, Gg, Gg, Gg, Gg, Gg, Gg, Gs, Gg, Gs, Gg, Gs, Gg, Gs, Gg, Gg, Gg, Gg, Gg, Gg, Gg, Gg, Gg, Gg, Gs, Gs, Gs^Fms, Gs^Fms, Gs^Fms, Gs, Rp, Rp, Rp, Rp, Rp, Gg, Gg, Gg, Gg, Gg, Gg, Gg, Ce, Gg, Gg, Gg, Gg, Gg, Gg, Gg, Gg, Gg, Gg, Gg, Gg, Gg, Gg, Gs, Gs, Gg, Gs, Gs, Gs
Gs, Gs, Gs, Gs, Gs, Gg, Gs, Gg, Gs, Gs, Gs, Gg, Gg, Gg, Gg, Gg, Gs, Gg, Gg, Gg, Gg, Gs, Gg, Gg, Gg, Gg, Gg, Gg, Gg, Gg, Gg, Gg, Gg, Gg, Gg, Gs, Gs, Gs, Gg, Rp, Rp, Rp, Gg, Gg, Gg, Gg, Gg, Gg, Gg, Gg, Gs, Gg, Gg, Gg, Gg, Gg, Gg, Gg, Gg, Gg, Gg, Gg, Gg, Gg, Gg, Gs, Gg, Gg, Gg, Gg, Gs, Gs
Gg, Gg, Gg, Gg, Gg, Gs, Gs, Gs, Gs, Gs, Gs, Gs, Gg, Gg, Gg, Gg, Gg, Gg, Gg, Gg, Gg, Gg, Gg, Gg, Gg, Gg, Gg, Gg, Gg, Gg, Gg, Gg, Gg, Gg, Gg, Gg, Gg, Gg, Gg, Rp, Rp, Rp, Gg, Gg, Gg, Gg, Gg, Gg, Gg, Gg, Gg, Gg, Gs, Gg, Gg, Gg, Gg, Gg, Gg, Gg, Gg, Gg, Gs, Gs, Gs, Gg, Gg, Gg, Gg, Gs, Gs, Gs
Gg, Gg, Gg, Gg, Gg, Gg, Gs, Gs, Gg, Gg, Gs, Gg, Gg, Gg, Gg, Gg, Gg, Gg, Gg, Gg, Hh, Hh, Hh, Gg, Gg, Gg, Gg, Gg, Gg, Gg, Gg, Gg, Gs, Gg, Gg, Gg, Gg, Gg, Gg, Rp, Rp, Rp, Gg, Gg, Gg, Gg, Gg, Gs, Gg, Gg, Gs, Gg, Gs, Gs, Gs, Gg, Gs, Gg, Gg, Gg, Gg, Gs, Gg, Gg, Gg, Gg, Gg, Gg, Gg, Gg, Gs, Gs
Gg, Gg, Gg, Gg, Gg, Gs, Gs, Gs, Gg, Gg, Gg, Gg, Gg, Gg, Gg, Gg, Hh, Hh, Hh, Hh, Hh^Fms, Hh^Fms, Hh^Fms, Hh, Hh, Gg, Gg, Gg, Gg, Gg, Gg, Gs, Gg, Gs, Gs, Gg, Gg, Gg, Gg, Rp, Rp, Rp, Gg, Gg, Gg, Gs, Gg, Gs, Gs, Gg, Gg, Gg, Gg, Gg, Gg, Gs, Gs, Gs, Gs, Gs, Gs, Gg, Gg, Gg, Gg, Gg, Gg, Gg, Gg, Gg, Gs, Gs
Gg, Gg, Gg, Gg, Gg, Gs, Gs, Gg, Gg, Gg, Gg, Gg, Gg, Gg, Gg, Gg, Hh, Hh, Hh, Hh, Hh^Fms, Hh^Fms, Hh^Fms, Hh^Fms, Hh^Fms, Hh, Gg, Gg, Gg, Gg, Gg, Gg, Gg, Gg, Gs, Gs, Gg, Gg, Gg, Rp, Rp, Rp, Gg, Gg, Gg, Gs, Gg, Gg, Gg, Gg, Gs, Gs, Gs, Gg, Gs, Gg, Gs, Gg, Gg, Gg, Gg, Gg, Gg, Gg, Gg, Gg, Gg, Gg, Gg, Gg, Gs, Gs
Gg, Gg, Gg, Gg, Gg, Gs, Gg, Gs, Gg, Gg, Gg, Gg, Gg, Gg, Gg, Gg, Hh, Hh, Hh^Fms, Hh^Fms, Hh^Fms, Hh^Fms, Hh^Fms, Hh^Fms, Hh^Fms, Hh, Hh, Gg, Gg, Gg, Gg, Gg, Gg, Gg, Gg, Gg, Gs, Gg, Gg, Rp, Rp, Rp, Gg, Gg, Gg, Gg, Gs, Gs, Gg, Gg, Gg, Gg, Gg, Gs, Gs, Gg, Gg, Gg, Gg, Gg, Gg, Gg, Gg, Gg, Gg, Gg, Gg, Gg, Gs, Gs, Gs^Fms, Gs
Gg, Gg, Gg, Gg, Gg, Gg, Gs, Gs, Gg, Gs, Gs, Gg, Gg, Gg, Hh, Hh, Hh, Hh, Hh^Fms, Hh^Fms, Hh^Fms, Hh^Fms, Hh^Fms, Hh^Fms, Hh^Fms, Hh, Hh, Hh, Gg, Gg, Gg, Gg, Gg, Gs, Gg, Gs, Gs, Gs, Gg, Rp, Rp, Rp, Gg, Gg, Gg, Gg, Gg, Gs, Gs, Gs, Gg, Gg, Gs, Gs, Gg, Gg, Gs, Gg, Gg, Gg, Gg, Gg, Gg, Gs, Gg, Gg, Gg, Gg, Gs, Gs^Fms, Gs^Fms, Gs^Fms
Gg, Gg, Gg, Gg, Gg, Gg, Gg, Gs, Gs, Gs, Gs, Gg, Gg, Gg, Gg, Hh, Hh, Hh^Fms, Hh^Fms, Hh^Fms, Hh^Fms, Hh^Fms, Hh^Fms, Hh^Fms, Hh^Fms, Hh, Hh, Gg, Gg, Gg, Gg, Gg, Gs, Gg, Gs, Gg, Gg, Gg, Gg, Rp, Rp, Rp, Gg, Gg, Gg, Gg, Gs, Gg, Gg, Gg, Gg, Gg, Gg, Gg, Gg, Gg, Gg, Gs, Gg, Gg, Gs, Gg, Gg, Gg, Gg, Gg, Gs, Gs, Gs^Fms, Gs^Fms, Gs^Fms, Gs^Fms
Gg, Gg, Gg, Gg, Gg, Gg, Gg, Gg, Gs, Gs, Gg, Gg, Gg, Gg, Gg, Gg, Hh, Hh^Fms, Hh^Fms, Hh^Fms, Hh^Fms, Hh^Fms, Hh^Fms, Hh^Fms, Hh, Hh, Gg, Gg, Gg, Gg, Gg, Gs, Gg, Gg, Gg, Gs, Gs, Gg, Gg, Rp, Rp, Rp, Gg, Gg, Gg, Gg, Gs, Gs, Gg, Gg, Gg, Gg, Gg, Gg, Gg, Gg, Gg, Gs, Gg, Gs, Gg, Gg, Gg, Gg, Gg, Gg, Gs, Gs^Fms, Gs^Fms, Gs^Fms, Gs^Fms, Gs^Fms
Gg, Gg, Gg, Gg, Gg, Gg, Gg, Gg, Gg, Gs, Gs, Gg, Gg, Gg, Gg, Gg, Gg, Hh, Hh, Hh^Fms, Hh, Hh^Fms, Hh, Hh^Fms, Hh, Hh, Gg, Gg, Gg, Gg, Gs, Gg, Gs, Gg, Gs, Gg, Gs, Gg, Gg, Rp, Rp, Rp, Gg, Gg, Gg, Gg, Gg, Gg, Gg, Gg, Gg, Gg, Gg, Gg, Gg, Gg, Gg, Gg, Gg, Gg, Gg, Gg, Gg, Gg, Gg, Gs, Gs^Fms, Gs^Fms, Gs^Fms, Gs^Fms, Gs^Fms, Gs^Fms
Gg, Gg, Gg, Gg, Gg, Gg, Gg, Gg, Gg, Gs, Gs, Gs, Gg, Gg, Gg, Gg, Gg, Gg, Gg, Hh, Gg, Hh, Gg, Hh, Gg, Gg, Gg, Gg, Gg, Gg, Gg, Gg, Gg, Gg, Gg, Gg, Gg, Gg, Gg, Rp, Rp, Rp, Gg, Gg, Gg, Gg, Gg, Gg, Gg, Gg, Gs, Gg, Gg, Gg, Gg, Gg, Gg, Gg, Gg, Gg, Gg, Gg, Gg, Gg, Gs, Gs, Gs^Fms, Gs^Fms, Gs^Fms, Gs^Fms, Gs^Fms, Gs^Fms
Gg, Gg, Gg, Gg, Ce, Ce, Ce, Gg, Gg, Gs, Gs, Gs, Gs, Gg, Gg, Gg, Gg, Gg, Gg, Gg, Gg, Gg, Gg, Gg, Gg, Gg, Gg, Gg, Gg, Gg, Gs, Gg, Gg, Gg, Gg, Gg, Gg, Gg, Gg, Rp, Rp, Rp, Gg, Gg, Gg, Gg, Gg, Gg, Gs, Gs, Gg, Gg, Gs, Gs, Gs, Gs, Gg, Gg, Gg, Gg, Gg, Gg, Gg, Gg, Gs, Gs^Fms, Gs^Fms, Gs^Fms, Gs^Fms, Gs^Fms, Gs^Fms, Gs^Fms
Gg, Gg, Gs, Ce, Ce, 7 Ke, Ce, Ce, Gg, Gs, Gs, Gs, Gs, Gs, Gs, Gs, Gs, Gg, Gg, Gg, Gg, Gg, Gg, Gg, Gg, Gg, Gs, Gs, Gg, Gs, Gg, Gs, Gs, Gg, Gs, Gg, Gg, Gg, Gg, Rp, Rp, Rp, Gg, Gg, Gg, Gg, Gg, Gs, Gg, Gs, Gg, Gg, Gg, Gg, Gg, Gg, Gs, Gg, Gg, Gg, Gg, Gg, Gg, Gg, Gs, Gs^Fms, Gs^Fms, Gs^Fms, Gs^Fms, Gs^Fms, Gs^Fms, Gs^Fms
Gs, Gs, Gs, Ce, Ce, Ce, Ce, Ce, Gg, Gg, Gs, Gs, Gg, Gs, Gs, Gs, Gg, Gg, Gs, Gg, Gg, Gg, Gg, Gg, Gg, Gg, Gg, Gg, Gs, Gg, Gs, Gs, Gg, Gg, Gg, Gs, Gg, Gg, Gg, Rp, Rp, Rp, Gg, Gg, Gg, Gg, Gg, Gg, Gg, Gs, Gg, Gg, Gg, Gg, Gs, Gg, Gg, Gs, Gg, Gg, Gg, Gg, Gg, Gg, Gs, Gs^Fms, Gs^Fms, Gs^Fms, Gs^Fms, Gs^Fms, Gs^Fms, Gs^Fms
Gs, Gs, Gs, Gg, Gs, Ce, Gs, Gg, Gg, Gg, Gs, Gs, Gs, Gs, Gg, Gs, Gs, Gg, Gs, Gs, Gs, Gg, Gg, Gs, Gg, Gs, Gs, Gs, Gg, Gs, Gg, Gg, Gg, Gs, Gs, Gg, Gg, Gg, Gg, Rp, Rp, Rp, Gg, Gg, Gg, Gg, Gg, Gg, Gg, Gg, Gs, Gg, Gs, Gs, Gg, Gg, Gg, Gg, Gg, Gg, Gg, Gg, Gg, Gg, Gs, Gs^Fms, Gs^Fms, Gs^Fms, Gs^Fms, Gs^Fms, Gs^Fms, Gs^Fms
Gs, Gs, Gs, Gg, Gg, Gg, Gs, Gs, Gs, Gs, Gs, Gs, Gs, Gs, Gs, Gg, Gs, Gs, Gs, Gg, Gg, Gg, Gg, Gg, Gs, Gg, Gs, Gg, Gg, Gg, Gg, Gg, Gg, Gs, Gg, Gg, Gg, Gg, Gg, Rp, Rp, Rp, Gg, Gg, Gg, Gg, Gg, Gg, Gg, Gg, Gg, Gg, Gg, Gg, Gg, Gg, Gs, Gg, Gg, Gg, Gg, Gg, Gg, Gg, Gg, Gs, Gs^Fms, Gs^Fms, Gs^Fms, Gs^Fms, Gll, Gs^Fms
Gs, Gs, Gg, Gg, Gg, Gs, Gg, Gs, Gs, Gg, Gs, Gg, Gs, Gs, Gs, Gs, Gs, Gs, Gg, Gg, Gg, Gg, Gg, Gg, Gs, Gg, Gs, Gg, Gg, Gs, Gg, Gg, Gg, Gg, Gg, Gg, Qxe, Gg, Cv, Rp, Gg^Bsb|, Rp, Cv, Gg, Qxe, Gg, Gg, Gg, Gg, Gg, Gg, Gg, Gs, Gs, Gg, Gs, Gg, Gs, Gg, Gg, Gg, Gg, Gs, Gs, Gs, Gs, Gll, Gs^Fms, Gll, Gll, Gll, Gll
Gg, Gg, Gg, Gg, Gg, Gg, Gg, Gs, Gs, Gs, Gs, Gg, Gg, Gs, Gg, Gs, Gg, Gs, Gs, Gs, Gg, Gg, Gg, Gs, Gg, Gg, Gs, Gg, Gg, Gs, Gg, Gg, Gg, Gg, Qxe, Qxe, Cv, Qxe, Cv, Ww^Bsb|, Ww^Bsb|, Ww^Bsb|, Cv, Qxe, Cv, Qxe, Qxe, Gg, Gg, Gg, Gg, Gg, Gg, Gs, Gs, Gg, Gg, Gg, Gg, Gg, Gs, Gg, Gg, Gg, Gs, Gs, Gll, Gll, Gs^Fms, Gs^Fms, Gs^Fms, Gll
Gg, Gg, Gg, Gg, Gg, Gg, Gg, Gg, Gg, Gs, Gg, Gg, Gg, Gg, Gg, Gg, Gg, Gg, Gg, Gg, Gg, Gg, Gg, Gs, Gg, Gg, Gg, Gs, Gg, Gg, Gg, Gg, Qxe, Qxe, Cv, Cv, Ww, Cv, Ww, Ww^Bsb|, Cv, Ww^Bsb|, Ww, Cv, Ww, Cv, Cv, Qxe, Qxe, Gg, Gg, Gg, Gg, Gg, Gg, Gs, Gg, Gg, Gs, Gs, Gg, Gs, Gs, Gg, Gs, Gs, Gs^Fms, Gs^Fms, Gs^Fms, Gs^Fms, Gs^Fms, Gs^Fms
Gg, Gg, Gg, Gg, Gg, Gg, Gg, Gg, Gg, Gg, Gg, Gg, Gg, Gs, Gg, Gs, Gs, Gg, Gs, Gs, Gs, Gg, Gs, Gg, Gg, Gg, Gg, Gg, Gg, Gg, Qxe, Qxe, Cv, Cv, Ww, Ww, Cv, Ww, Ww, Cv, 1 Kv, Cv, Ww, Ww, Cv, Ww, Ww, Cv, Cv, Qxe, Qxe, Gg, Gg, Gg, Gg, Gg, Gg, Gg, Gs, Gg, Gg, Gg, Gg, Gg, Gg, Gs, Gs^Fms, Gs^Fms, Hh^Fms, Hh^Fms, Gs^Fms, Gs^Fms
Gg, Gg, Gg, Gg, Gg, Gg, Gg, Gs, Gg, Gg, Gg, Gs, Gg, Gg, Gg, Gg, Gg, Gg, Gs, Gg, Gg, Gg, Gg, Gg, Gg, Gg, Gg, Gg, Qxe, Qxe, Cv, Cv, Ww, Ww, Cv, Kv, Rrc, Kv, Rrc, Cv, Cv, Cv, Rrc, Kv, Rrc, Kv, Cv, Ww, Ww, Cv, Cv, Qxe, Qxe, Gg, Gg, Gg, Gg, Gs, Gs, Gg, Gs, Gg, Gg, Gs, Gs, Gs, Gs^Fms, Gs^Fms, Hh^Fms, Hh^Fms, Gs^Fms, Gs^Fms
Rp, Rp, Rp, Rp, Rp, Gg, Gg, Gg, Gs, Gs, Gg, Gg, Gg, Gs, Gg, Gg, Gs, Gg, Gg, Gg, Gg, Gg, Gg, Gg, Gg, Gg, Gg, Qxe, Qxe, Cv, Ww, Ww, Cv, Kv, Re^Vct, Rrc, Rrc, Re^Vct, Rrc, Cv, Rrc, Cv, Rrc, Rrc, Re^Vct, Rrc, Re^Vct, Kv, Cv, Ww, Ww, Cv, Qxe, Qxe, Gg, Gg, Gg, Gg, Gg, Gg, Gg, Gs, Gs, Gs, Gs, Gs^Fms, Gs^Fms, Hh^Fms, Hh^Fms, Hh^Fms, Hh^Fms, Gs^Fms
Rp, Rp, Rp, Rp, Rp, Rp, Rp, Gg, Gg, Gg, Gg, Gg, Gg, Gg, Gg, Gs, Gg, Gs, Gg, Gg, Gg, Gg, Gg, Gg, Gg, Gg, Rp, Qxe, Cv, Cv, Ww, Kv, Rrc, Rrc, Rrc, Re^Vct, Kv, Cv, Kv, Rrc, Rr^Vhc, Rrc, Kv, Cv, Kv, Rrc, Rrc, Rrc, Rrc, Kv, Ww, Cv, Cv, Qxe, Rp, Gg, Gg, Gg, Gg, Gg, Gg, Gg, Gg, Gs, Gs^Fms, Gs^Fms, Gs^Fms, Hh^Fms, Hh^Fms, Hh^Fms, Hh^Fms, Gs^Fms
Gs^Fms, Rp, Gs^Fms, Rp, Rp, Rp, Rp, Rp, Rp, Gg, Gg, Gg, Gg, Gg, Gg, Gg, Gg, Gg, Gg, Gg, Gg, Gg, Gg, Gg, Gg, Rp, Rp, Rp, Cv, Ww, Kv, Cv, Rrc, Re^Vct, Cv, Kv, Rrc, Rrc, Rrc, Rrc, Rrc, Rrc, Rrc, Rrc, Rrc, Kv, Cv, Re^Vct, Rrc, Cv, Kv, Ww, Cv, Rp, Rp, Rp, Rp, Gg, Gg, Gg, Gg, Gg, Gg, Gs, Gs^Fms, Gs^Fms, Gs^Fms, Hh^Fms, Hh^Fms, Hh^Fms, Gs^Fms, Gs^Fms
Gs^Fms, Gs^Fms, Hh, Gs^Fms, Gs^Fms, Gs^Fms, Rp, Rp, Rp, Rp, Rp, Gg, Gg, Gg, Gg, Gg, Gg, Gg, Gg, Gg, Gg, Gg, Gg, Gg, Gg, Rp, Rp, Gg^Bsb\, Ww^Bsb\, Ww, Rrc, Rrc, Rrc, Rrc, Kv, Rrc, Rr^Vhc, Rrc, Kv, Rrc, Cv, Rrc, Kv, Rrc, Rr^Vhc, Rrc, Kv, Re^Vct, Re^Vct, Rrc, Rrc, Ww, Ww^Bsb/, Gg^Bsb/, Rp, Rp, Rp, Rp, Rp, Gg, Rp, Gg, Gg, Gs, Gs^Fms, Gs^Fms, Gs^Fms, Gs^Fms, Gs^Fms, Gs^Fms, Gs^Fms, Gs^Fms
Gs^Fms, Hh, Hh, Hh, Hh, Gs^Fms, Gs^Fms, Rp, Rp, Rp, Rp, Rp, Rp, Rp, Rp, Rp, Rp, Rp, Rp, Rp, Rp, Rp, Rp, Rp, Rp, Rp, Cv, Cv, Ww, Ww^Bsb\, Cv, Cv, 5 Kv, Rrc, Re^Vct, Rrc, Rrc, Rrc, Cv, Cv, 2 Kv, Cv, Cv, Rrc, Rr^Vhc, Rrc, Rrc, Rrc, 3 Kv, Cv, Cv, Ww^Bsb/, Ww, Cv, Cv, Rp, Gs, Rp, Rp, Rp, Rp, Rp, Rp, Gs, Gs, Gs^Fms, Gs^Fms, Gs^Fms, Gs^Fms, Gs^Fms, Gll, Gll
Gs^Fms, Hh, Hh^Fms, Hh^Fms, Hh^Fms, Hh, Hh, Gs^Fms, Gs^Fms, Rp, Rp, Rp, Rp, Rp, Rp, Rp, Rp, Rp, Rp, Rp, Rp, Rp, Rp, Rp, Rp, Rp, Cv, Ww, Ww, Cv, Cv, Cv, Cv, Rrc, Rrc, Rrc, Rr^Vhc, Rrc, Cv, Cv, Kv, Cv, Cv, Rrc, Rrc, Rr^Vhc, Rrc, Rrc, Cv, Cv, Cv, Cv, Ww, Ww, Cv, Rp, Gs, Rp, Rp, Rp, Rp, Rp, Rp, Rp, Rp, Rp, Rp, Rp, Rp, Rp, Rp, Rp
Gs^Fms, Hh, Hh^Fms, Hh^Fms, Hh^Fms, Hh^Fms, Hh, Gs^Fms, Rp, Rp, Rp, Rp, Gg, Rp, Gg, Rp, Gg, Rp, Gg, Rp, Gg, Rp, Gg, Rp, Gg, Rp, Rp, Cv, Ww^Bsb/, Ww^Bsb/, Rrc, Cv, Rrc, Rrc, Kv, Rrc, Rr^Vhc, Rrc, Kv, Cv, Cv, Cv, Kv, Rrc, Rr^Vhc, Rrc, Kv, Rrc, Rrc, Cv, Rrc, Ww^Bsb\, Ww^Bsb\, Cv, Rp, Rp, Rp, Rp, Rp, Rp, Rp, Rp, Rp, Rp, Rp, Rp, Rp, Rp, Rp, Rp, Rp, Rp
Gs^Fms, Hh, Hh, Hh^Fms, Hh^Fms, Hh^Fms, Hh, Gs^Fms, Rp, Rp, Rp, Gg, Gg, Gg, Gg, Gg, Gg, Gg, Gg, Gg, Gg, Gg, Gg, Gg, Gg, Rp, Rp, Gg^Bsb/, Cv, Ww, Kv, Rrc, Rrc, Re^Vct, Cv, Rrc, Rrc, Rrc, Rrc, Rrc, Rrc, Rrc, Rrc, Rrc, Rrc, Rrc, Cv, Re^Vct, Rrc, Rrc, Kv, Ww, Cv, Gg^Bsb\, Rp, Rp, Rp, Rp, Gg, Gg, Gg, Gg, Gg, Rp, Gs, Rp, Gs^Fms, Rp, Gs^Fms, Rp, Gll, Gll
Gs^Fms, Gs^Fms, Hh, Hh^Fms, Hh, Hh, Gs^Fms, Rp, Rp, Rp, Gg, Gg, Gg, Gg, Gg, Gg, Gg, Gg, Gg, Gg, Gg, Gg, Gg, Gg, Gg, Rp, Rp, Rp, Cv, Ww, Ww, Cv, Rrc, Rrc, Re^Vct, Kv, Kv, Rrc, Kv, Rrc, Rr^Vhc, Rrc, Kv, Rrc, Kv, Kv, Re^Vct, Rrc, Re^Vct, Cv, Ww, Ww, Cv, Rp, Rp, Rp, Gg, Gs, Gg, Gg, Gg, Gg, Gg, Gs, Gs^Fms, Gs^Fms, Gs^Fms, Gs^Fms, Gs^Fms, Gs^Fms, Gs^Fms, Gll
Rp, Gs^Fms, Gs^Fms, Hh, Hh, Gs^Fms, Rp, Rp, Rp, Rp, Gg, Gg, Gg, Gg, Gg, Gg, Gs, Gg, Gg, Gs, Gg, Gg, Gg, Gg, Gg, Gg, Gg, Qxe, Qxe, Cv, Ww, Kv, Cv, Rrc, Rrc, Rrc, Re^Vct, Cv, Rrc, Rrc, Rrc, Rrc, Rrc, Cv, Rrc, Rrc, Rrc, Rrc, Cv, Kv, Ww, Cv, Qxe, Qxe, Gg, Gg, Gg, Gs, Gg, Gg, Gs, Gg, Gg, Gs, Gs^Fms, Gs^Fms, Gs^Fms, Gs^Fms, Gs^Fms, Gs^Fms, Gs^Fms, Gs^Fms
Rp, Rp, Rp, Gs^Fms, Gs^Fms, Gs^Fms, Rp, Rp, Rp, Rp, Gg, Gg, Gs, Gs, Gg, Gs, Gg, Gg, Gs, Gs, Gg, Gs, Gg, Gg, Gg, Gg, Gg, Qxe, Qxe, Cv, Cv, Ww, Ww, Kv, Cv, Re^Vct, Rrc, Re^Vct, Rrc, Cv, Cv, Cv, Rrc, Re^Vct, Rrc, Re^Vct, Cv, Kv, Ww, Ww, Cv, Cv, Qxe, Qxe, Gg, Gg, Gg, Gs, Gg, Gs, Gg, Gs, Gs, Gs, Gs^Fms, Gs^Fms, Gs^Fms, Hh, Hh, Gs^Fms, Gs^Fms, Gs^Fms
Rp, Rp, Rp, Rp, Rp, Rp, Rp, Rp, Rp, Rp, Gg, Gg, Gs, Gg, Gs, Gg, Gg, Gg, Gg, Gg, Gg, Gs, Gg, Gs, Gs, Gg, Gg, Gg, Gg, Qxe, Qxe, Cv, Cv, Ww, Ww, Kv, Cv, Kv, Ww, Cv, 4 Kv, Cv, Ww, Kv, Cv, Kv, Ww, Ww, Cv, Cv, Qxe, Qxe, Gg, Gg, Gg, Gg, Gg, Gg, Gs, Gg, Gs, Gg, Gs, Gs, Gs^Fms, Gs^Fms, Hh, Hh, Hh, Hh, Gs^Fms, Gs^Fms
Rp, Rp, Rp, Rp, Rp, Rp, Rp, Rp, Rp, Rp, Gg, Gg, Gg, Gs, Gg, Gg, Gs, Gs, Gg, Gg, Gg, Gs, Gs, Gg, Gg, Gs, Gg, Gg, Gg, Gg, Gg, Qxe, Qxe, Cv, Cv, Ww, Ww, Ww, Ww, Cv, Cv, Cv, Ww, Ww, Ww, Ww, Cv, Cv, Qxe, Qxe, Gg, Gg, Gg, Gg, Gg, Gg, Gs, Gg, Gg, Gs, Gg, Gg, Gs, Gs, Gs^Fms, Gs^Fms, Hh, Hh, Hh, Hh, Gs^Fms, Gs^Fms
Gg, Gg, Gg, Rp, Rp, Rp, Rp, Rp, Gg, Gg, Gg, Gg, Gg, Gg, Gg, Gg, Gg, Gg, Gg, Gg, Gs, Gg, Gg, Gg, Gg, Gg, Gg, Gg, Gg, Gg, Gg, Gg, Gg, Qxe, Qxe, Cv, Cv, Cv, Cv, Ww^Bsb|, Ww^Bsb|, Ww^Bsb|, Cv, Cv, Cv, Cv, Qxe, Qxe, Gg, Gg, Gg, Gg, Gg, Gg, Gs, Gg, Gs, Gg, Gs, Gs, Gg, Gg, Gs, Gs^Fms, Gs^Fms, Gs^Fms, Gs^Fms, Hh, Gs^Fms, Gs^Fms, Gs^Fms, Gs^Fms
Gg, Gg, Gg, Gg, Gg, Gg, Gg, Gg, Gg, Gg, Gg, Gg, Gs, Gg, Gs, Gg, Gg, Gg, Gs, Gs, Gg, Gg, Gs, Gg, Gg, Gs, Gs, Gg, Gg, Gg, Gg, Gg, Gg, Gg, Gg, Qxe, Qxe, Qxe, Cv, Ww^Bsb|, Gg^Bsb|, Ww^Bsb|, Cv, Qxe, Qxe, Qxe, Gg, Gg, Gg, Gg, Gg, Gg, Gg, Gs, Gs, Gg, Gg, Gg, Gg, Gg, Gg, Gg, Gs, Gs^Fms, Gs^Fms, Gs^Fms, Gs^Fms, Gs^Fms, Gs^Fms, Gs^Fms, Gs^Fms, Gs^Fms
Gg, Gg, Gg, Gg, Gg, Gg, Gg, Gg, Gs, Gg, Gs, Gs, Gg, Gg, Gg, Gs, Gg, Gg, Gs, Gg, Gg, Gg, Gg, Gs, Gg, Gg, Gg, Gg, Gg, Gg, Gg, Gg, Gg, Gg, Gg, Gg, Gg, Gg, Gg, Gg^Bsb|, Rp, Gg^Bsb|, Gg, Gg, Gg, Gg, Gs^Fms, Gs^Fms, Gs^Fms, Gg, Gs, Gg, Gs, Gg, Gg, Gg, Gg, Gg, Gg, Gg, Gs, Gs, Gs^Fms, Re, Re, Gs^Fms, Gs^Fms, Gs^Fms, Gs^Fms, Gs^Fms, Gs^Fms, Gs^Fms
Gg, Gg, Gg, Gg, Gs, Gg, Gs, Gg, Gg, Gs, Gs, Gg, Gg, Gg, Gs, Gg, Gs, Gg, Gg, Gg, Gg, Gg, Gg, Gg, Gg, Gg, Gg, Gg, Gg, Gs, Gg, Gs, Gs, Gs, Gg, Gg, Gg, Gg, Gg, Rp, Rp, Rp, Gg, Gg, Gs^Fms, Gs^Fms, Gs^Fms, Gs^Fms, Gs^Fms, Gs^Fms, Gs^Fms, Gs, Gs, Gs, Gg, Gg, Gg, Gg, Gg, Gg, Gs, Gs^Fms, Gs^Fms, Gs^Fms, Gs^Fms, Gs, Re, Gs^Fms, Re, Gs^Fms, Gs, Re
Gg, Gg, Gg, Gg, Gg, Gg, Gs, Gg, Gg, Gg, Gg, Gg, Gg, Gg, Gs, Gg, Gg, Gg, Gg, Gs, Gg, Gg, Gg, Gs, Gs, Gg, Gg, Gg, Gg, Gs, Gg, Gg, Gs^Fms, Gs^Fms, Gs^Fms, Gg, Gg, Gg, Gg, Rp, Rp, Rp, Gg, Gs^Fms, Gs^Fms, Gs^Fms, Gs^Fms, Gs^Fms, Gs^Fms, Gs^Fms, Gs^Fms, Gg, Gg, Gg, Gg, Gg, Gg, Gg, Gs, Gs, Gs^Fms, Gs^Fms, Gs^Fms, Gs^Fms, Gs^Fms, Gs^Fms, Gs^Fms, Gs^Fms, Gs^Fms, Gs, Re, Gs
Gg, Gg, Gg, Gg, Gg, Gg, Gg, Gs, Ce, Gg, Gg, Gs, Gg, Gg, Gg, Gg, Gg, Gs, Gg, Gg, Gg, Gg, Gg, Gg, Gg, Gg, Gg, Gg, Gg, Gs, Gg, Gs, Gs^Fms, Gs^Fms, Gs^Fms, Gs^Fms, Gs^Fms, Gg, Gg, Rp, Rp, Rp, Gg, Gs^Fms, Gs^Fms, Gs^Fms, Gs^Fms, Gs^Fms, Gs^Fms, Gs^Fms, Gs, Gg, Gg, Gg, Gg, Gg, Gg, Gs, Gs^Fms, Gs^Fms, Gs^Fms, Gs^Fms, Hh, Gs^Fms, Hh, Hh, Hh, Gs^Fms, Gs^Fms, Re, Gs, Gs
Gg, Gg, Gg, Gg, Gs, Gg, Ce, Ce, 9 Ke, Ce, Ce, Gs, Gs, Gg, Gs, Gg, Gg, Gg, Gg, Gg, Gg, Gg, Gs, Gs, Gg, Gg, Gg, Gs, Gg, Gg, Gg, Gg, Gg, Gs^Fms, Gs^Fms, Gs^Fms, Gs^Fms, Gs^Fms, Gs^Fms, Rp, Rp, Rp, Gs^Fms, Gs^Fms, Gs^Fms, Gs^Fms, Gs^Fms, Gs^Fms, Gs^Fms, Gs^Fms, Gg, Gg, Gg, Gg, Gg, Gg, Gg, Gs, Gs^Fms, Gs^Fms, Gs^Fms, Gs^Fms, Hh, Hh, Hh^Fms, Hh^Fms, Hh, Gs^Fms, Gs^Fms, Gs^Fms, Gs^Fms, Gs
Gg, Gg, Gg, Gg, Gg, Gs, Ce, Ce, Ce, Ce, Ce, Gg, Gg, Gg, Gs, Gg, Gg, Gg, Gg, Gg, Gg, Gg, Gg, Gg, Gg, Gs, Gg, Gg, Gg, Gs, Gg, Gs, Gs^Fms, Gs^Fms, Gs^Fms, Gs^Fms, Gs^Fms, Gs^Fms, Gs^Fms, Rp, Rp, Rp, Gs^Fms, Gs^Fms, Gs^Fms, Gs^Fms, Gs^Fms, Gg, Gg, Gg, Gg, Gg, Gg, Gg, Gg, Gg, Gg, Gs, Gs^Fms, Gs^Fms, Gs^Fms, Gs^Fms, Gs^Fms, Hh, Hh, Hh^Fms, Hh, Hh, Gs^Fms, Gs^Fms, Gs^Fms, Gs^Fms
Gg, Gs, Gs, Gg, Gg, Gg, Gg, Ce, Ce, Ce, Gg, Gg, Gs, Gs, Gg, Gg, Gg, Gg, Gg, Gg, Gg, Gg, Gg, Gg, Gg, Gg, Gs, Gs, Gg, Gg, Gg, Gs^Fms, Gs^Fms, Gs^Fms, Gs^Fms, Gs^Fms, Gs^Fms, Gs^Fms, Gs^Fms, Rp, Rp, Rp, Gs^Fms, Gs^Fms, Gs^Fms, Gs^Fms, Gs^Fms, Gg, Gg, Gg, Gg, Gg, Gg, Gg, Gg, Gg, Gg, Gs, Gs, Gs^Fms, Gs^Fms, Gs^Fms, Gs^Fms, Gs^Fms, Gs^Fms, Hh, Hh, Hh, Gs^Fms, Gs^Fms, Gs^Fms, Gs^Fms
Gg, Gg, Gg, Gg, Gs, Gg, Gs, Gg, Gg, Gg, Gg, Gg, Gg, Gs, Gg, Gg, Gg, Gg, Gg, Gg, Gg, Gg, Gg, Gg, Gg, Gg, Gg, Gg, Gs, Gg, Gg, Gs^Fms, Gs^Fms, Gs^Fms, Gs^Fms, Gs^Fms, Gs^Fms, Gs^Fms, Gg, Rp, Rp, Rp, Gs^Fms, Gs^Fms, Gs^Fms, Gs^Fms, Gg, Gg, Gs, Gs, Gg, Gs, Gg, Gg, Gg, Gg, Gg, Gs, Gg, Gs, Gs, Gs^Fms, Gs^Fms, Gs^Fms, Gs^Fms, Gs^Fms, Gs^Fms, Gs^Fms, Gs^Fms, Gs^Fms, Gs^Fms, Gs^Fms
Gg, Gg, Gg, Gs, Gg, Gg, Gg, Gg, Gs, Gg, Gg, Gg, Gg, Gg, Gg, Gg, Gg, Gg, Gs, Gs, Gg, Gg, Gg, Gs, Gg, Gg, Gg, Gg, Gg, Gs, Gg, Gg, Gs, Gs^Fms, Gs, Gs^Fms, Gg, Gg, Gg, Rp, Rp, Rp, Gg, Gs^Fms, Gg, Gg, Gg, Gg, Gs, Gg, Gg, Gs, Gs, Gg, Gg, Gg, Gg, Gg, Gg, Gg, Gg, Gs, Gs, Gs^Fms, Gs, Gs^Fms, Gs^Fms, Gs^Fms, Gs^Fms, Gs^Fms, Gs^Fms, Gs^Fms
Gg, Gg, Gg, Gg, Gg, Gg, Rp, Gg, Gg, Gg, Gg, Gg, Gg, Gg, Gs, Gg, Gs, Gg, Gg, Gg, Gs, Gg, Gg, Gg, Gg, Gg, Gs, Gs, Gg, Gg, Gg, Gg, Gs, Gs, Gg, Gg, Gg, Gg, Rp, Rp, Rp, Rp, Gg, Gg, Gg, Gg, Gs, Gs, Gg, Gg, Gg, Gg, Gg, Gg, Gg, Gg, Gg, Gg, Gs, Gg, Gg, Gs, Gs, Gs, Gs, Gs, Gs^Fms, Gs^Fms, Gs^Fms, Gs^Fms, Gs^Fms, Gs^Fms
Rp, Gg, Rp, Rp, Rp, Rp, Rp, Rp, Rp, Gg, Gg, Gg, Gg, Gg, Gs, Gg, Gs, Gg, Gg, Gg, Gg, Gg, Gg, Gg, Gg, Gg, Gg, Gg, Gs, Gg, Gs, Gs, Gg, Gg, Gg, Gg, Rp, Rp, Rp, Rp, Rp, Rp, Gg, Gg, Gg, Gg, Gs, Gg, Gg, Gg, Gg, Gs, Gs, Gs, Gg, Gg, Gg, Gg, Gg, Gg, Gg, Gg, Gg, Gg, Gg, Gs, Gs^Fms, Gs^Fms, Gs^Fms, Gs^Fms, Gs^Fms, Gs^Fms
Rp, Rp, Rp, Rp, Rp, Rp, Rp, Rp, Rp, Rp, Rp, Gg, Gg, Gg, Gg, Gg, Gg, Gg, Gg, Gg, Gg, Gg, Gg, Gg, Gg, Gg, Gg, Gg, Gg, Gs, Gg, Gg, Gg, Gg, Rp, Rp, Rp, Rp, Rp, Rp, Rp, Rp, Gg, Gg, Gg, Gg, Gs, Gg, Gg, Gg, Gg, Gg, Gg, Gg, Gg, Gg, Gg, Gg, Gs, Gg, Gg, Gg, Gg, Gg, Gg, Gs, Gs, Gs^Fms, Gs, Gs^Fms, Gs^Fms, Gs^Fms
Rp, Rp, Rp, Rp, Rp, Rp, Gs^Fms, Rp, Rp, Rp, Rp, Rp, Rp, Gg, Gg, Gg, Gg, Gg, Gg, Gg, Gg, Gg, Gg, Gg, Rp, Rp, Rp, Gg, Gg, Gg, Gg, Gg, Rp, Rp, Rp, Rp, Rp, Rp, Rp, Rp, Rp, Rp, Gg, Gg, Gg, Gg, Gg, Gs, Gg, Gg, Gg, Gg, Gg, Gg, Gg, Gs, Gg, Gs, Gg, Gg, Gs, Gs, Gg, Gg, Gg, Gg, Gg, Gs, Gs, Gs^Fms, Gs^Fms, Gs^Fms
Gs^Fms, Rp, Hh^Fms, Gs^Fms, Hh^Fms, Gs^Fms, Hh^Fms, Gs^Fms, Gs^Fms, Rp, Rp, Rp, Rp, Rp, Rp, Gg, Gg, Gg, Gg, Gg, Gg, Gg, Rp, Rp, Rp, Rp, Rp, Rp, Rp, Gg, Rp, Rp, Rp, Rp, Rp, Rp, Hh, Hh, Hh, Rp, Rp, Rp, Gg, Gg, Gg, Gg, Gg, Gg, Gg, Gg, Gg, Gg, Gs, Gg, Gg, Gg, Gs, Gs, Gg, Gg, Gg, Gs, Gg, Gg, Gg, Gs, Gg, Gg, Gs, Gs^Fms, Gs^Fms, Gs^Fms
Hh^Fms, Hh^Fms, Md, Md, Md, Hh^Fms, Md, Md, Md, Gs^Fms, Gs^Fms, Rp, Rp, Rp, Rp, Rp, Rp, Gg, Gg, Gg, Rp, Rp, Rp, Rp, Rp, Rp, Rp, Rp, Rp, Rp, Rp, Rp, Rp, Rp, Hh, Hh, Hh, Hh, Hh, Rp, Rp, Rp, Gg, Gg, Gg, Gg, Gs, Gs, Gs, Gg, Gg, Gs, Gg, Gg, Gg, Gg, Gs, Gg, Gs, Gg, Gg, Gg, Ce, Gg, Gg, Gg, Gg, Gg, Gs, Gs^Fms, Gs^Fms, Gs^Fms
Md, Md, Md, Md, Md, Md, Md, Md, Md, Md, Md, Hh^Fms, Hh^Fms, Rp, Rp, Rp, Rp, Rp, Rp, Rp, Rp, Rp, Rp, Rp, Gg, Gg, Gg, Rp, Rp, Rp, Rp, Rp, Gg, Gg, Hh, Hh, Hh, Hh, Hh, Rp, Rp, Rp, Gg, Gg, Gg, Gg, Gg, Gg, Gg, Gs, Gg, Gg, Gs, Gg, Gg, Gs, Gg, Gg, Gg, Gg, Ce, Ce, Ce, Ce, Ce, Gs, Gg, Gg, Gs, Gs, Gs^Fms, Gs^Fms
Md, Md, Md, Md, Md, Md, Md, Md, Md, Md, Md, Md, Md, Hh^Fms, Hh^Fms, Rp, Rp, Rp, Rp, Rp, Rp, Rp, Gg, Gg, Gg, Gg, Gs, Gg, Gg, Rp, Gg, Gg, Gg, Gg, Gg, Hh, Hh, Hh, Hh, Rp, Rp, Rp, Gg, Gg, Gg, Gg, Gg, Gg, Gg, Gg, Gg, Gs, Gs, Gg, Gg, Gs, Gg, Gg, Gg, Gg, Ce, Ce, 8 Ke, Ce, Ce, Gs, Gs, Gs, Gs, Gs, Gs^Fms, Gs^Fms
Md, Md, Md, Md, Md^Xm, Md^Xm, Md^Xm, Md, Md, Md, Md, Md, Md, Hh^Fms, Md, Hh^Fms, Rp, Rp, Rp, Rp, Gg, Gg, Gg, Gg, Gs, Gs, Gg, Gg, Gs, Gg, Gs, Gg, Gg, Gg, Gg, Hh, Hh, Hh, Gg, Rp, Rp, Rp, Gg, Gg, Gs, Gs, Gg, Gg, Gg, Gg, Gs, Gs, Gg, Gg, Gg, Gg, Gg, Gg, Gg, Gs, Gg, Ce, Ce, Ce, Gs, Gs, Gg, Gs, Gs^Fms, Gs^Fms, Gs^Fms, Gs^Fms
Md, Md, Md, Md^Xm, Md^Xm, Md^Xm, Md^Xm, Md, Md, Md, Md, Md, Md, Md, Md, Md, Rp, Rp, Rp, Gg, Gg, Gg, Gg, Gg, Gg, Gg, Gg, Gs, Gg, Gg, Gg, Gs, Gs, Gg, Gg, Gg, Gg, Gg, Gg, Rp, Rp, Rp, Gg, Gg, Gg, Gg, Gg, Gg, Gg, Gg, Gs, Gg, Gg, Gg, Gs, Gs, Gg, Gg, Gg, Gs, Gs, Gs, Gg, Gs, Gg, Gg, Gg, Gs, Gs^Fms, Gs^Fms, Gs^Fms, Gs^Fms
Md, Md, Md^Xm, Md^Xm, Md^Xm, Md^Xm, Md^Xm, Md, Md, Md, Md, Md, Md, Md, Md, Md, Rp, Rp, Rp, Gg, Gg, Gg, Gg, Gs, Gg, Gg, Gs, Gg, Gs, Gg, Gg, Gg, Gg, Gg, Gg, Gg, Gg, Gg, Gg, Rp, Rp, Rp, Gg, Gg, Gs, Gg, Gg, Gg, Gs, Gs, Gs, Gg, Gg, Gs, Gs, Gg, Gs, Gs, Gg, Gg, Gg, Gs, Gg, Gg, Gg, Gg, Gs, Gs, Gs^Fms, Gs^Fms, Gs^Fms, Gs^Fms
Md, Md, Md^Xm, Md^Xm, Md^Xm, Md^Xm, Md^Xm, Md, Md, Md, Hh^Fms, Hh^Fms, Hh^Fms, Md, Rp, Rp, Rp, Rp, Rp, Gg, Gg, Gg, Gg, Gs, Gg, Gg, Gs, Gs, Gg, Gs, Gg, Gg, Gs, Gg, Gg, Gg, Gg, Gg, Gg, Rp, Rp, Rp, Gg, Gg, Gg, Gs, Gg, Gg, Gg, Gg, Gg, Gs, Gg, Gg, Gg, Gg, Gs, Gs, Gs, Gg, Gs, Gs, Gg, Gg, Gg, Gs, Gs^Fms, Gs^Fms, Gs^Fms, Gs^Fms, Gs^Fms, Gs^Fms
Md, Md, Md, Md^Xm, Md^Xm, Md^Xm, Md, Md, Md, Md, Hh^Fms, Hh^Fms, Rp, Rp, Rp, Rp, Rp, Rp, Gg, Gg, Gs, Gg, Gg, Gg, Gg, Gg, Gg, Gs, Gg, Gg, Gg, Gs, Gs, Gs, Gg, Gg, Gs, Gg, Gg, Rp, Rp, Rp, Gg, Gg, Gg, Gg, Gg, Gg, Gg, Gg, Gg, Gg, Gg, Gg, Gg, Gg, Gg, Gs, Gg, Gs, Gg, Gg, Gg, Gg, Gs, Gs, Gs^Fms, Gs^Fms, Gs^Fms, Gs^Fms, Gs^Fms, Gs^Fms
Md, Md, Md, Md, Md, Md, Md, Md, Md, Md, Rp, Rp, Rp, Rp, Rp, Rp, Gg, Gg, Gg, Gs, Gg, Gg, Gg, Gg, Gg, Gg, Gg, Gs, Gg, Gg, Gg, Gs, Gg, Gs, Gg, Gs, Gg, Gs, Gg, Rp, Rp, Rp, Gg, Gg, Gg, Gg, Gg, Gg, Gs, Gs, Gg, Gg, Gg, Gg, Gg, Gg, Gg, Gg, Gg, Gg, Gg, Gg, Gs, Gs, Gs^Fms, Gs^Fms, Gs^Fms, Gs^Fms, Gs^Fms, Gs^Fms, Gs^Fms, Gs^Fms
Md, Md, Md, Md, Md, Md, Md, Md, Md, Md, Rp, Rp, Rp, Rp, Gg, Gg, Gg, Gg, Gg, Gg, Gg, Gg, Gg, Gg, Gg, Gg, Gg, Gs, Gg, Gg, Gg, Gg, Gg, Gs, Gg, Gg, Gg, Gg, Gg, Rp, Rp, Rp, Gg, Gg, Gg, Gg, Gg, Gg, Gg, Gg, Gg, Gg, Gg, Gg, Gg, Gg, Gg, Gg, Gg, Gg, Gg, Gs, Gs^Fms, Gs^Fms, Gs^Fms, Gs^Fms, Gs^Fms, Gs^Fms, Gs^Fms, Gs^Fms, Gs^Fms, Gs^Fms
Gg, Md, Md, Md, Md, Md, Gg, Md, Md, Md, Rp, Rp, Rp, Gg, Gg, Gg, Gg, Gg, Gg, Gg, Gg, Gg, Gg, Gg, Gg, Gg, Gg, Gg, Gg, Gg, Gg, Gg, Gg, Gg, Gg, Gg, Gg, Gg, Gg, Rp, Rp, Rp, Gg, Gg, Gg, Gg, Gg, Gg, Gg, Gg, Gg, Gg, Gg, Gg, Gg, Gg, Gg, Gg, Gg, Gg, Gg, Gs, Gs^Fms, Gs^Fms, Gs^Fms, Gs^Fms, Gs^Fms, Gs^Fms, Gs^Fms, Gs^Fms, Gs^Fms, Gs^Fms
