border_size=1
usage=map

Gs^Fms, Gs^Fms, Gs^Fms, Gs^Fms, Gs^Fms, Gs^Fms, Gs^Fms, Gs^Fms, Gs^Fms, Gs^Fms, Gs^Fms, Gs^Ecf, Gd^Fetd, Gs^Fms, Gs^Fms, Gs^Fms, Gs^Fms, Gs^Fms, Gs^Fms, Gs^Fms, Gs^Fms, Gs^Fms, Gs^Fms, Gs^Fms, Gs^Fms, Gs^Fms, Gs^Fms, Gs^Fms, Gs^Fms, Gs^Fms, Gs^Fms, Gs^Fms, Gs^Fms, Gs, Gs, Gg, Gg, Gg, Gg, Gg, Gg, Gg, Gg, Gg, Gg, Ww, Ww, Wo, Wo
Gs^Fms, Gs^Fms, Gs^Fms, Gs^Fms, Gs^Fms, Gs^Fms, Gd^Fetd, Gs^Fms, Gd^Fetd, Gs^Fms, Gs^Fms, Gs^Ecf, Gs^Fms, Gs^Fms, Gs^Fms, Gs^Fms, Gs^Ecf, Gs^Ecf, Gd^Fetd, Gd^Fetd, Gd^Fetd, Gd^Fetd, Gs^Fms, Gs^Fms, Gs^Fms, Gs^Fms, Gd^Fetd, Gs^Fms, Gs^Fms, Gs^Fms, Gd^Fetd, Gd^Fetd, Gs^Fms, Gs^Fms, Gs, Gg, Gg, Gg, Gg, Gg, Gg^Es, Gg^Es, Gg, Gg, Gg, Ww, Ww, Wo, Wo
Gs^Fms, Gs^Fms, Gs^Fms, Gd^Fetd, Gd^Fetd, Gd^Fetd, Gs^Fms, Gd^Fetd, Gd^Fetd, Gd^Fetd, Gs^Ecf, Gs^Ecf, Gd^Fetd, Gs^Fms, Gd^Fetd, Gs^Fms, Gs^Ecf, Gd^Fetd, Gs^Ecf, Gs^Fms, Gs^Ecf, Gd^Fetd, Gd^Fetd, Gs^Fms, Gd^Fetd, Gd^Fetd, Gd^Ecf, Gd^Fetd, Gd^Fetd, Gd^Fetd, Gd^Ecf, Gd^Fetd, Gd^Fetd, Gs^Fms, Gs^Fms, Gs, Gs, Gg, Gg, Gg^Es, Gg, Gg^Es, Gg^Es, Gg, Gg, Gg, Ww, Wo, Ww
Gs^Fms, Gs^Fms, Gd^Fetd, Gd^Ecf, Gd^Ecf, Gs^Fms, Gs^Ecf, Gs^Fms, Gs^Ecf, Gd^Fetd, Gd^Fetd, Gs^Fms, Gd^Fetd, Gd^Fetd, Gd^Fetd, Gs^Ecf, Gs^Ecf, Gd^Fetd, Gd^Fetd, Gs^Ecf, Gs^Fms, Gs^Ecf, Gd^Fetd, Gs^Fms, Gd^Ecf, Gd^Fetd, Gd^Ecf, Gd^Ecf, Gs^Fms, Gs^Fms, Gs^Fms, Gs^Fms, Gs^Fms, Gd^Fetd, Gs^Fms, Gs^Fms, Gs, Gg, Gg, Gg, Gg, Gg, Gg^Es, Gg, Gg, Gg, Ww, Wo, Wo
Gs^Fms, Gd^Fetd, Gd^Fetd, Gd^Fetd, Gs^Fms, Gs^Ecf, Gs^Fms, Gs^Fms, Gs^Fms, Gs^Ecf, Gs^Fms, Gd^Fetd, Gd^Fetd, Gd^Fetd, Gd^Fetd, Gs^Ecf, Gd^Fetd, Gd, Gd^Fetd, Gd^Fetd, Gs^Fms, Gs^Ecf, Gd^Fetd, Gs^Fms, Gd^Ecf, Gd^Ecf, Gd^Ecf, Gd^Fetd, Gd^Fetd, Gd^Fetd, Gd^Fetd, Gd, Gs^Fms, Gs^Fms, Gs^Fms, Gs^Fms, Gs, Gg, Gg, Gg, Gg, Gg, Gg, Gg, Gg, Gg, Ww, Ww, Wo
Gs^Fms, Gs^Fms, Gd, Gd^Fetd, Gd^Fetd, Gs^Fms, Gd^Fetd, Gd^Fetd, Gd^Fetd, Gd^Fetd, Gs^Fms, Gd^Fetd, Gd^Fetd, Gd^Fetd, Gd^Ecf, Gd, Gd^Fetd, Gd^Fetd, Gs^Ecf, Gd^Fetd, Gs^Ecf, Gs^Ecf, Gs^Fms, Gd^Fetd, Gd^Fetd, Gd^Fetd, Gd^Fetd, Gd^Ecf, Gs^Fms, Gd^Fetd, Gd^Ecf, Gd^Fetd, Gd^Fetd, Gs^Fms, Gs^Fms, Gs^Fms, Gs, Gs, Gg, Gg, Gg, Gg, Gg^Es, Gg, Gg, Gg, Ww, Wo, Ww
Gs^Fms, Gs^Fms, Gs^Fms, Gd, Gd^Fetd, Gd^Fetd, Gd^Ecf, Gd^Ecf, Gd^Fetd, Gs^Fms, Gs^Fms, Gs^Fms, Gs^Fms, Gd^Fetd, Gd^Ecf, Gd^Fetd, Gd^Fetd, Gs^Ecf, Gs^Fms, Gs^Ecf, Gs^Ecf, Gs^Fms, Gd^Fetd, Gd^Ecf, Gd^Fetd, Gd^Fetd, Gd^Ecf, Gs^Fms, Gd^Fetd, Gd^Fetd, Gd^Ecf, Gd^Ecf, Gd^Ecf, Gd^Fetd, Gs^Fms, Gs^Fms, Gs, Gg, Gg, Gg, Gg, Gg, Gg, Gg, Gg, Ww, Ww, Wo, Ww
Gs^Fms, Gs^Fms, Gd^Fetd, Gd, Gd, Gd, Gs^Fms, Gs^Fms, Gd^Fetd, Gs^Ecf, Gs^Fms, Gs^Fms, Gs^Fms, Gd^Fetd, Gd^Fetd, Gs^Fms, Gs^Fms, Gs^Ecf, Gd^Fetd, Gd^Fetd, Gd^Fetd, Gd^Fetd, Gd^Fetd, Gd^Ecf, Gs^Fms, Gd^Ecf, Gd^Fetd, Gd^Fetd, Gd^Fetd, Gd^Ecf, Gd^Ecf, Gd^Fetd, Gd^Ecf, Gs^Fms, Gs^Fms, Gs^Fms, Gs, Gg, Gg, Gg, Gg, Gg, Gg^Es, Gg, Gg, Ww, Wo, Wo, Ww
Gs^Fms, Gd^Fetd, Gs^Fms, Gd^Ecf, Gd^Fetd, Gd^Fetd, Gs^Fms, Gd^Fetd, Gs^Ecf, Gs^Ecf, Gd^Fetd, Gd^Fetd, Gd^Fetd, Gd^Fetd, Gs^Fms, Gs^Fms, Gd^Fetd, Gd^Fetd, Gs^Fms, Gs^Fms, Gs^Fms, Gs^Fms, Gd^Fetd, Gd^Ecf, Gd^Fetd, Gd^Fetd, Gd^Fetd, Gd^Ecf, Gd^Ecf, Gd^Fetd, Gd^Ecf, Gd^Fetd, Gd^Fetd, Gd^Fetd, Gd^Fetd, Gs^Fms, Gs^Fms, Gs, Gg, Gg, Gg, Gg^Es, Gg, Gg, Gg, Ww, Wo, Wo, Ww
Gs^Fms, Gs^Ecf, Gs^Fms, Gs^Fms, Gs^Ecf, Gs^Fms, Gs^Ecf, Gs^Fms, Gs^Fms, Gs^Fms, Gs^Fms, Gs^Fms, Gs^Fms, Gd^Fetd, Gd^Fetd, Gd^Ecf, Gd^Ecf, Gd^Fetd, Gd^Fetd, Gs^Fms, Gs^Ecf, Gs^Ecf, Gs^Fms, Gd^Fetd, Gd^Fetd, Gd^Fetd, Gs^Ecf, Gd^Fetd, Gd^Ecf, Gd^Fetd, Gs^Ecf, Gs^Fms, Gd^Fetd, Gs^Fms, Gd^Fetd, Gs^Fms, Gs^Fms, Gs, Gg, Gg, Gg^Es, Gg^Es, Gg, Gg, Ww, Ww, Wo, Wo, Ww
Gs^Fms, Gs^Ecf, Gs^Ecf, Gs^Ecf, Gs^Fms, Gs^Fms, Gs^Fms, Gs^Fms, Gd^Fetd, Gs^Fms, Gs^Fms, Gs^Fms, Gs^Fms, Gd^Ecf, Gs^Fms, Gd^Fetd, Gs^Fms, Gs^Fms, Gs^Fms, Gd^Fetd, Gs^Fms, Gs^Ecf, Gs^Fms, Gd^Fetd, Gd^Fetd, Gs^Fms, Gs^Ecf, Gd^Fetd, Gd^Fetd, Gd^Fetd, Gd^Fetd, Gs^Ecf, Gd^Fetd, Gd^Fetd, Gd^Fetd, Gs^Fms, Gs^Fms, Gs, Gg, Gg, Gg^Es, Gg, Gg, Gg, Ww, Wo, Wo, Wo, Ww
Gs^Fms, Gs^Fms, Gs^Fms, Gs^Fms, Gd^Fetd, Gd^Fetd, Gd^Fetd, Gd^Fetd, Gd^Ecf, Gd^Fetd, Gd^Fetd, Gd^Fetd, Gd^Fetd, Gd^Fetd, Gs^Fms, Gd^Fetd, Gd^Fetd, Gs^Fms, Gd^Fetd, Gd^Fetd, Gs^Fms, Gs^Ecf, Gs^Fms, Gd^Fetd, Gd^Fetd, Gs^Fms, Gs^Ecf, Gs^Fms, Gd^Fetd, Gd^Fetd, Gs^Ecf, Gs^Ecf, Gd^Fetd, Gd^Fetd, Gs^Fms, Gs^Fms, Gs, Gs, Gg, Gg, Gg, Gg, Gg, Gg, Ww, Wo, Ww, Ww, Gg
Gs^Fms, Gs^Fms, Gs^Fms, Gs^Fms, Gd^Fetd, Gd^Fetd, Gs^Ecf, Gs^Ecf, Gd^Fetd, Gd, Gd, Gs^Ecf, Gd^Fetd, Gs^Ecf, Gd^Fetd, Gs^Fms, Gs^Fms, Gs^Fms, Gs^Fms, Gs^Fms, Gd^Ecf, Gs^Ecf, Gs^Fms, Gd^Fetd, Gs^Fms, Gd^Fetd, Gs^Fms, Gs^Ecf, Gs^Ecf, Gs^Ecf, Gs^Fms, Gs^Fms, Gd^Fetd, Gs^Fms, Gs^Fms, Gs^Fms, Gs, Gs, Gg, Gg, Gg^Es, Gg, Gg, Ww, Wo, Wo, Ww, Gg, Gg
Gs^Fms, Gs^Fms, Gs^Fms, Gs^Fms, Gs^Fms, Gs^Fms, Gs^Fms, Gs^Fms, Gs^Fms, Gd^Fetd, Gd^Fetd, Gd^Fetd, Gd^Fetd, Gd^Fetd, Gd^Fetd, Gs^Fms, Gs^Fms, Gs^Fms, Gs^Fms, Gs^Fms, Gd^Fetd, Gs^Ecf, Gs^Fms, Gd^Fetd, Gs^Fms, Gs^Fms, Gd^Fetd, Gs^Ecf, Gs^Fms, Gs^Fms, Gd^Fetd, Gd^Fetd, Gs^Fms, Gs^Fms, Gs^Fms, Gs^Fms, Gs, Gg, Gg, Gg, Gg^Es, Gg, Gg, Ww, Wo, Wo, Ww, Gg, Gg
Gs^Fms, Gs^Fms, Gs^Fms, Gs^Fms, Gs, Gs^Fms, Gs^Fms, Gs^Fms, Gs^Fms, Gs^Fms, Gd^Fetd, Gd^Ecf, Gd^Fetd, Gs^Ecf, Gd^Fetd, Gd^Fetd, Gs^Fms, Gs^Fms, Gd^Fetd, Gs^Fms, Gs^Ecf, Gd^Fetd, Gs^Fms, Gs^Fms, Gs^Fms, Gs^Fms, Gs^Ecf, Gd^Fetd, Gd^Fetd, Gs^Fms, Gs^Fms, Gs^Fms, Gs^Fms, Gs^Fms, Gs^Fms, Gs^Fms, Gs, Gg, Gg, Gg, Gg, Gg, Gg, Ww, Ww, Wo, Wo, Ww, Gg
Gs, Gs^Fms, Gll, Gs, Gll, Gs, Gll, Gs, Gs, Gs, Gs, Gd^Fetd, Gd^Fetd, Gd^Fetd, Gd^Fetd, Gd^Fetd, Gs^Fms, Gd^Fetd, Gs^Fms, Gs^Fms, Gs^Ecf, Gd^Fetd, Gs^Fms, Gs^Fms, Gd^Fetd, Gs^Ecf, Gs^Ecf, Gs^Ecf, Gs^Fms, Gd^Fetd, Gs^Fms, Gs^Fms, Gs^Fms, Gs^Fms, Gs^Fms, Gs^Fms, Gs, Gs, Gg^Es, Gg, Gg, Gg, Gg, Gg, Ww, Wo, Wo, Ww, Ww
Gg, Gs, Gll, Gs, Gs^Es, Gll, Gll^Es, Gll, Gs^Es, Gll, Gll, Gd^Ecf, Gd^Ecf, Gd^Ecf, Gd^Ecf, Gd^Ecf, Gd^Fetd, Gd^Fetd, Gd^Fetd, Gs^Ecf, Gd^Fetd, Gd^Fetd, Gs^Fms, Gs^Fms, Gs^Ecf, Gd^Fetd, Gd^Fetd, Gs^Fms, Gd^Fetd, Gd^Fetd, Gd^Fetd, Gs^Fms, Gs^Fms, Gs^Fms, Gs, Gs, Gs, Gg, Gg, Gg^Es, Gg^Es, Gg, Gg, Gg, Gg, Ww, Ww, Wo, Wo
Gs, Gs, 1 Gll^Es, Gll^Es, Gll, Gll, Gs, Gs, Gll^Es, Gll, Gs, Gd^Ecf, Gd^Ecf, Gd^Ecf, Gd^Ecf, Gd^Ecf, Gs, Gd^Fetd, Gd^Fetd, Gs^Ecf, Gs^Ecf, Gs^Fms, Gs^Fms, Gs^Fms, Gs^Ecf, Gs^Ecf, Gs^Fms, Gs^Fms, Gd^Fetd, Gd^Ecf, Gd^Fetd, Gs^Fms, Gs^Fms, Gs, Gs, Gs, Gs, Gg, Gg, Gg, Gg, Gg, Gg, Gg, Gg, Gg, Gg, Ww, Ww
Gg, Gs, Gll, Gll, Gs, Gll, Gs, Gll, Gll, Gs^Es, Gd^Ecf, Gd^Ecf, Gd^Ecf, Gd^Ecf, Gd^Ecf, Gd^Ecf, Gs^Es, Gd^Ecf, Gd^Fetd, Gd^Fetd, Gd^Fetd, Gd^Fetd, Gd^Fetd, Gll^Ecf, Gd^Fetd, Gs, Gs, Gs^Fms, Gs^Fms, Gd^Fetd, Gd^Ecf, Gs^Fms, Gs^Fms, Gs, Gs, Gs, Gg, Gg, Gg, Gg, Gg, Gg^Es, Gg^Es, Gg^Es, Gg^Es, Gg, Gg, Gg, Gg
Gg, Gll, Gs, Gll, Gll, Gll^Es, Gs, Gs, Gs^Fms, Gll, Gd^Ecf, Gd^Fetd, Gd^Fetd, Gd^Ecf, Gd^Ecf, Gd^Ecf, Gs, Gs, Gd^Fetd, Gd^Fetd, Gll^Ecf, Gd^Fetd, Gd^Fetd, Gs^Ecf, Gd^Fetd, Gs^Fms, Gs^Fms, Gs, Gs, Gd^Fetd, Gd^Fetd, Gs^Fms, Gs, Gs, Gg, Gg, Gg, Gg, Gg, Gg, Gg, Gg, Gg, Gg, Gg, Gg, Gg, Gg, Gg
Gs^Fms, Gs^Fms, Gs^Fms, Gs, Gs^Fms, Gs^Fms, Gs^Fms, Gs^Fms, Gs^Fms, Gs^Fms, Gd^Ecf, Gd^Fetd, Gs^Fms, Gd^Fetd, Gd^Ecf, Gd^Ecf, Gd^Fetd, Gd^Fetd, Gs^Fms, Gll^Ecf, Gs, Gd^Fetd, Gll^Ecf, Gd^Fetd, Gs^Fms, Gs^Fms, Gs^Fms, Gs^Fms, Gll, Gs, Gs, Gs, Gs, Gs, Gg, Gg, Gg, Gg, Gg, Gg, Gg, Gg, Gg^Es, Gg^Es, Gg, Gg, Gg, Gg, Gg
Gd^Fetd, Gs^Fms, Gs^Fms, Gs^Fms, Gs^Fms, Gs^Fms, Gd^Fetd, Gs^Fms, Gd^Fetd, Gd^Ecf, Gd^Fetd, Gd^Fetd, Gd^Fetd, Gd^Fetd, Gd^Ecf, Gd^Fetd, Gd^Fetd, Gs^Fms, Gs^Ecf, Gs^Fms, Gs, Gd^Fetd, Gs, Gd^Fetd, Gs^Fms, Gs^Fms, Gs^Fms, Gs^Fms, Gll^Es, Gll, Gs^Es, Gs, Gs, Gs, Gg, Gg, Gg^Es, Gg, Gg, Gg, Gg^Es, Gg, Gg, Gg, Gg, Gg, Ww, Ww, Ww
Gs^Fms, Gd^Fetd, Gd^Fetd, Gs^Fms, Gd^Fetd, Gd^Fetd, Gs^Fms, Gd^Fetd, Gs^Fms, Gs^Ecf, Gs^Ecf, Gd^Fetd, Gs^Fms, Gd^Ecf, Gd^Fetd, Gd^Fetd, Gs^Fms, Gd^Fetd, Gd^Fetd, Gs^Ecf, Gs^Fms, Gs^Fms, Gs^Es, Gd^Fetd, Gs, Gll, Gs, Gs, Gs, Gll^Es, Gs, Gs^Es, Gs, Gs, Gg, Gg^Es, Gg^Es, Gg, Gg, Gg^Es, Gg, Gg, Gg, Gg, Ww, Ww, Wo, Wo, Ww
Gs^Fms, Gs^Fms, Gs^Fms, Gd^Fetd, Gd^Fetd, Gs^Fms, Gs^Fms, Gs^Fms, Gs^Fms, Gs^Ecf, Gs^Fms, Gs^Ecf, Gs^Fms, Gs^Fms, Gs^Fms, Gd^Fetd, Gs^Fms, Gs^Fms, Gd^Fetd, Gs^Ecf, Gs^Fms, Gs^Fms, Gs^Fms, Gs^Fms, Gs^Fms, Gs^Fms, Gs^Fms, Gs^Fms, Gs^Fms, Gs^Fms, Gs^Fms, Gs, Gs, Gs, Gg, Gg, Gg^Es, Gg, Gg^Es, Gg^Es, Gg, Gg, Gg, Gg, Ww, Wo, Ww, Ww, Gg
Gs^Fms, Gs^Fms, Gs^Fms, Gs^Fms, Gd^Fetd, Gs^Fms, Gs^Ecf, Gs^Ecf, Gs^Ecf, Gs^Fms, Gd^Fetd, Gs^Fms, Gd^Fetd, Gs^Fms, Gs^Fms, Gd^Fetd, Gd^Fetd, Gd^Fetd, Gd^Fetd, Gd^Fetd, Gd^Fetd, Gs^Ecf, Gs^Fms, Gs^Fms, Gs^Ecf, Gs^Fms, Gd^Fetd, Gd^Fetd, Gd^Fetd, Gs^Fms, Gs^Fms, Gs^Fms, Gs^Fms, Gs, Gg, Gg, Gg, Gg, Gg^Es, Gg, Gg, Gg, Gg, Gg, Ww, Wo, Ww, Gg, Gg
Gs^Fms, Gs^Fms, Gs^Fms, Gs^Fms, Gd^Fetd, Gd^Fetd, Gs^Ecf, Gd^Fetd, Gs^Ecf, Gd^Fetd, Gs^Ecf, Gd^Fetd, Gs^Fms, Gd^Fetd, Gd^Fetd, Gd^Ecf, Gd^Ecf, Gd^Ecf, Gd^Fetd, Gd^Ecf, Gd^Fetd, Gs^Ecf, Gs^Ecf, Gs^Ecf, Gs^Ecf, Gd^Fetd, Gd^Ecf, Gd^Ecf, Gd^Fetd, Gs^Ecf, Gs^Ecf, Gs^Fms, Gs^Fms, Gs, Gg, Gg, Gg, Gg, Gg^Es, Gg, Gg, Gg, Ww, Ww, Wo, Wo, Ww, Gg, Gg
Gs^Fms, Gs^Fms, Gs^Fms, Gd^Fetd, Gs^Ecf, Gs^Fms, Gs^Fms, Gs^Ecf, Gd^Fetd, Gs^Ecf, Gs^Fms, Gs^Fms, Gs^Fms, Gs^Fms, Gs^Fms, Gs^Fms, Gs^Fms, Gs^Fms, Gs^Fms, Gd^Ecf, Gd^Ecf, Gd^Fetd, Gd^Fetd, Gd^Fetd, Gd^Fetd, Gd^Fetd, Gd^Fetd, Gd^Fetd, Gd^Fetd, Gd^Fetd, Gd^Fetd, Gs^Fms, Gs^Fms, Gs, Gg, Gg, Gg, Gg, Gg, Gg, Gg, Gg, Ww, Wo, Ww, Ww, Gg, Gg, Gg
Gs^Ecf, Gs^Ecf, Gs^Ecf, Gs^Ecf, Gs^Ecf, Gs^Ecf, Gs^Fms, Gs^Fms, Gs^Fms, Gd^Fetd, Gs^Fms, Gd^Fetd, Gs^Fms, Gs^Fms, Gs^Fms, Gs^Fms, Gd^Fetd, Gs^Fms, Gs^Fms, Gs^Fms, Gd^Fetd, Gd^Fetd, Gd^Ecf, Gd^Ecf, Gd^Fetd, Gd^Fetd, Gd^Fetd, Gd^Fetd, Gd^Fetd, Gs^Fms, Gs^Ecf, Gs^Fms, Gs, Gs, Gg, Gg, Gg^Es, Gg, Gg, Gg, Gg, Gg, Ww, Wo, Ww, Gg, Gg, Gg, Gg
Gs^Ecf, Gd^Fetd, Gd^Fetd, Gd^Fetd, Gd^Fetd, Gd^Fetd, Gd^Fetd, Gs^Fms, Gs^Fms, Gs^Fms, Gs^Fms, Gs^Fms, Gd^Fetd, Gs^Fms, Gs^Fms, Gd^Fetd, Gd^Ecf, Gd^Fetd, Gd^Fetd, Gs^Fms, Gs^Fms, Gd^Ecf, Gd^Fetd, Gd^Fetd, Gs^Ecf, Gd^Fetd, Gs^Fms, Gd^Fetd, Gs^Ecf, Gs^Ecf, Gs^Fms, Gs^Fms, Gs, Gs, Gg, Gg^Es, Gg^Es, Gg, Gg, Gg, Gg, Gg, Ww, Ww, Gg, Gg, Gg, Gg, Gg
Gs^Ecf, Gd^Fetd, Gs^Ecf, Gs^Ecf, Gs^Ecf, Gs^Fms, Gs^Fms, Gs^Fms, Gs^Fms, Gs^Fms, Gs^Fms, Gs^Fms, Gd^Ecf, Gd^Fetd, Gd^Fetd, Gd^Fetd, Gd^Ecf, Gd^Ecf, Gs^Fms, Gd^Fetd, Gs^Fms, Gs^Fms, Gs^Fms, Gs^Fms, Gs^Ecf, Gs^Fms, Gs^Fms, Gs^Ecf, Gs^Fms, Gs^Fms, Gd^Fetd, Gs^Fms, Gs^Fms, Gs, Gg, Gg, Gg, Gg^Es, Gg^Es, Gg, Gg, Ww, Wo, Ww, Ww, Gg, Gg, Gg, Gg
Gs^Fms, Gs^Ecf, Gs^Fms, Gs^Fms, Gd^Fetd, Gs^Ecf, Gs^Fms, Gs^Fms, Gs^Fms, Gs^Fms, Gs^Fms, Gs^Fms, Gd^Ecf, Gd^Ecf, Gd^Fetd, Gd^Ecf, Gd^Fetd, Gs^Fms, Gs^Fms, Gs^Fms, Gs^Fms, Gs^Fms, Gs^Fms, Gs^Ecf, Gd^Fetd, Gd^Fetd, Gs^Fms, Gs^Fms, Gs^Fms, Gd^Fetd, Gd^Fetd, Gs^Fms, Gs, Gs, Gg, Gg, Gg, Gg, Gg, Gg, Gg, Ww, Ww, Wo, Ww, Gg, Gg, Gg, Gg
Gd^Fetd, Gd^Fetd, Gd^Ecf, Gd^Fetd, Gd^Ecf, Gd^Fetd, Gd^Fetd, Gd^Fetd, Gd^Fetd, Gs^Fms, Gs^Fms, Gd^Fetd, Gd^Fetd, Gd^Ecf, Gd^Ecf, Gd^Fetd, Gd^Ecf, Gd^Fetd, Gs^Fms, Gs^Fms, Gs^Fms, Gs^Fms, Gd^Fetd, Gd^Fetd, Gd^Ecf, Gd^Fetd, Gd^Fetd, Gs^Fms, Gs^Fms, Gd^Fetd, Gd^Ecf, Gs^Fms, Gs, Gs, Gs, Gg, Gg, Gg, Gg, Gg, Gg, Gg, Ww, Wo, Wo, Ww, Gg, Gg, Gg
Gs^Fms, Gs^Fms, Gd^Ecf, Gd^Ecf, Gd^Ecf, Gd^Ecf, Gd^Fetd, Gs^Fms, Gd^Ecf, Gd^Fetd, Gd^Fetd, Gs^Fms, Gs^Fms, Gd^Fetd, Gd^Fetd, Gd^Fetd, Gd^Fetd, Gd^Ecf, Gs^Fms, Gd^Fetd, Gs^Fms, Gs^Fms, Gd^Ecf, Gd^Ecf, Gs^Fms, Gd^Ecf, Gd^Fetd, Gs^Fms, Gs^Fms, Gd^Fetd, Gd^Fetd, Gs^Fms, Gs^Fms, Gs^Fms, Gs, Gg, Gg, Gg, Gg, Gg, Gg, Gg, Gg, Ww, Wo, Ww, Ww, Gg, Gg
Gs^Fms, Gs^Fms, Gd^Fetd, Gd^Fetd, Gd^Ecf, Gd^Ecf, Gd^Ecf, Gd^Ecf, Gd^Ecf, Gd^Ecf, Gd^Fetd, Gd^Fetd, Gd^Fetd, Gs^Fms, Gd^Fetd, Gd^Ecf, Gd^Ecf, Gd^Fetd, Gs^Fms, Gd^Fetd, Gs^Fms, Gd^Fetd, Gd^Ecf, Gd, Gd^Fetd, Gs^Fms, Gd^Fetd, Gs^Fms, Gs^Fms, Gs^Fms, Gd^Fetd, Gs^Fms, Gs^Fms, Gs^Fms, Gs, Gg, Gg, Gg, Gg, Gg, Gg, Gg, Gg, Ww, Ww, Wo, Ww, Gg, Gg
Gs^Fms, Gs^Fms, Gd^Fetd, Gd^Fetd, Gs^Fms, Gd^Fetd, Gd^Fetd, Gd^Ecf, Gd^Fetd, Gd^Ecf, Gd^Ecf, Gd^Fetd, Gs^Fms, Gd^Fetd, Gd^Ecf, Gd^Ecf, Gd^Fetd, Gd^Fetd, Gs^Fms, Gd^Fetd, Gs^Fms, Gd^Fetd, Gd^Ecf, Gd^Fetd, Gd^Fetd, Gs^Fms, Gs^Fms, Gs^Fms, Gs^Fms, Gd^Fetd, Gd^Fetd, Gs^Fms, Gs^Fms, Gs^Fms, Gs, Gg, Gg, Gg, Gg, Gg^Es, Gg^Es, Gg, Gg, Gg, Ww, Wo, Ww, Gg, Gg
Gs^Fms, Gs^Fms, Gs^Fms, Gs^Fms, Gs^Fms, Gd^Fetd, Gs^Fms, Gd^Ecf, Gd^Fetd, Gd^Ecf, Gd^Fetd, Gd^Fetd, Gs^Fms, Gd^Fetd, Gd^Ecf, Gd^Ecf, Gd^Fetd, Gs^Fms, Gs^Fms, Gs^Fms, Gs^Fms, Gd^Fetd, Gd^Fetd, Gd^Ecf, Gd^Ecf, Gd^Fetd, Gd^Fetd, Gs^Fms, Gs^Fms, Gs^Fms, Gs^Fms, Gs^Fms, Gd^Fetd, Gs^Fms, Gs^Fms, Gs, Gg, Gg, Gg, Gg, Gg, Gg, Gg, Gg, Ww, Wo, Ww, Gg, Gg
Gs^Fms, Gs^Fms, Gs^Fms, Gs^Ecf, Gs^Ecf, Gs^Fms, Gs^Fms, Gs^Ecf, Gd^Fetd, Gd^Fetd, Gd^Fetd, Gd^Fetd, Gs^Fms, Gd^Fetd, Gd^Fetd, Gs^Fms, Gs^Fms, Gd^Fetd, Gd^Fetd, Gs^Fms, Gd^Fetd, Gs^Fms, Gs^Fms, Gd^Fetd, Gd^Fetd, Gd^Fetd, Gs^Fms, Gs^Fms, Gs^Fms, Gs^Fms, Gs^Fms, Gs^Fms, Gd^Fetd, Gs^Fms, Gs^Fms, Gs, Gg, Gg, Gg, Gg, Gg, Gg, Gg^Es, Gg, Ww, Wo, Ww, Gg, Gg
Gs^Fms, Gs^Fms, Gd^Fetd, Gd^Fetd, Gs^Ecf, Gs^Fms, Gs^Ecf, Gs^Ecf, Gs^Fms, Gs^Fms, Gs^Fms, Gs^Fms, Gs^Fms, Gs^Fms, Gs^Fms, Gs^Fms, Gs^Fms, Gs^Fms, Gs^Fms, Gs^Fms, Gd^Fetd, Gs^Fms, Gs^Fms, Gs^Fms, Gd^Fetd, Gd^Fetd, Gd^Fetd, Gd^Fetd, Gd^Fetd, Gd^Fetd, Gd^Fetd, Gs^Fms, Gs^Fms, Gs^Fms, Gs^Fms, Gs, Gg, Gg, Gg, Gg, Gg, Gg, Gg^Es, Gg, Ww, Wo, Wo, Ww, Gg
Gs^Fms, Gd^Fetd, Gd^Fetd, Gs^Ecf, Gs^Ecf, Gs^Ecf, Gd^Fetd, Gs^Fms, Gd^Fetd, Gd^Fetd, Gd^Fetd, Gs^Fms, Gd^Fetd, Gd^Fetd, Gs^Fms, Gs^Fms, Gs^Fms, Gs^Fms, Gs^Fms, Gs^Fms, Gs^Fms, Gs^Fms, Gd^Fetd, Gd^Fetd, Gs^Fms, Gd^Fetd, Gs^Fms, Gd^Fetd, Gd^Fetd, Gs^Fms, Gd^Fetd, Gs^Fms, Gs^Fms, Gs^Fms, Gs^Fms, Gs, Gg, Gg, Gg, Gg, Gg^Es, Gg^Es, Gg^Es, Gg, Ww, Wo, Wo, Ww, Ww
Gs^Fms, Gs^Fms, Gs^Fms, Gd^Fetd, Gd^Fetd, Gd^Fetd, Gs^Fms, Gs^Fms, Gs^Fms, Gs^Fms, Gs^Fms, Gs^Fms, Gs^Fms, Gs^Fms, Gs^Fms, Gs^Fms, Gs^Fms, Gs^Fms, Gs^Fms, Gs^Fms, Gs^Fms, Gd^Fetd, Gd^Fetd, Gs^Fms, Gs^Fms, Gs^Fms, Gs^Fms, Gs^Fms, Gs^Fms, Gs^Fms, Gs^Fms, Gd^Fetd, Gs^Fms, Gs^Fms, Gs^Fms, Gs, Gg, Gg, Gg, Gg, Gg, Gg, Gg, Gg, Gg, Ww, Ww, Wo, Ww
Gs^Fms, Gs^Fms, Gs^Fms, Gs^Fms, Gs^Fms, Gs^Fms, Gs^Fms, Gs^Fms, Gs^Fms, Gs^Fms, Gs^Fms, Gs^Fms, Gg, Gs^Fms, Gs^Fms, Gs^Fms, Gs^Fms, Gs^Fms, Gs^Fms, Gs^Fms, Gs^Fms, Gs^Fms, Gs^Fms, Gs^Fms, Gs^Fms, Gs^Fms, Gs^Fms, Gs^Fms, Gs^Fms, Gs^Fms, Gs^Fms, Gs^Fms, Gs^Fms, Gs^Fms, Gs^Fms, Gs, Gg, Gg^Es, Gg, Gg, Gg, Gg, Gg, Gg, Gg, Gg, Ww, Wo, Ww