border_size=1
usage=map

Gd, Gd, Gd, Gll, Gll^Fdf, Gll^Fdf, Gll^Fdf, Gll^Fdf, Gll^Fdf, Gll, Gd, Gd, Gd, Gd, Gll, Gll^Fdf, Gll^Fdf, Gll^Fdf, Gll^Fdf, Gll^Fdf, Gll^Fdf, Gll^Fdf, Gll, Gd, Gd, Gd, Gd, Gd, Gd, Gd, Gd, Wo, Wo, Gd, Gd, Gd, Gd, Gd, Gd, Gd, Gd, Gd, Gd, Gd, Gd, Gd, Gd, Gd, Gd, Gd, Gd, Gll^Fdf, Gll^Fdf, Gll^Fdf, Gll^Fdf, Gll^Fdf, Gll^Fdf, Gll^Fdf, Gll^Fdf, Gll^Fdf, Gll^Fdf, Gll^Fdf, Gd, Gd, Gd, Gd, Gd, Gd, Gd, Gll^Fdf, Gll^Fdf, Gll^Fdf, Gll^Fdf, Hhd^Fdf, Hhd^Fdf, Hhd^Fdf, Hhd^Fdf, Hhd^Fdf, Gll^Fdf, Gll^Fdf, Gll^Fdf, Gd, Gd, Gd, Gd, Gd, Gd, Gd, Hhd, Hhd^Fdf, Hhd^Fdf, Hhd^Fdf, Hhd^Fdf, Hhd^Fdf, Hhd^Fdf, Hhd^Fdf, Hhd^Fdf, Hhd^Fdf, Hhd, Gd, Gd, Gd, Gd, Gd, Gd, Gd, Gd, Gd, Gd, Gd, Gd, Gd, Gd, Gd, Gd, Gd, Gd, Gd
Gd, Gd, Gd, Gll, Gll^Fdf, Gll^Fdf, Gll^Fdf, Gll^Fdf, Gll, Gll, Gd, Gd, Gd, Gd, Gll, Gll^Fdf, Gll^Fdf, Gll^Fdf, Hhd^Fdf, Gll^Fdf, Gll^Fdf, Gll^Fdf, Gd, Gd, Gd, Gd, Gd, Gd, Gd, Gd, Gd, Wo, Wo, Gd, Gd, Gd, Gd, Gd, Gd, Gd, Gd, Gd, Gd, Gd, Gd^Es, Gd, Gd, Gd, Gd, Gd, Gd, Gll^Fdf, Gll^Fdf, Gll^Fdf, Gll^Fdf, Gll^Fdf, Gll^Fdf, Gll^Fdf, Gll^Fdf, Gll^Fdf, Gll^Fdf, Gll^Fdf, Gd, Gd, Gd, Gd, Gd, Gd, Gd, Gll^Fdf, Gll^Fdf, Gll^Fdf, Gll^Fdf, Hhd^Fdf, Hhd^Fdf, Hhd^Fdf, Hhd^Fdf, Hhd^Fdf, Gll^Fdf, Gll^Fdf, Gll^Fdf, Gd, Gd, Gd, Gd, Gd, Gd, Gd, Hhd, Hhd^Fdf, Hhd^Fdf, Hhd^Fdf, Hhd^Fdf, Hhd^Fdf, Hhd^Fdf, Hhd^Fdf, Hhd^Fdf, Hhd^Fdf, Hhd, Gd, Gd, Gd, Gd, Gd, Gd, Gd, Gd, Gd, Gd, Gd, Gd, Gd, Gd, Gd, Gd, Gd, Gd, Gd
Gd, Gd, Gll, Gll, Gll, Gll, Gll, Gll, Gll, Gll, Gd, Gd, Gd, Gd, Gd, Gll^Fdf, Gll^Fdf, Hhd^Fdf, Hhd^Fdf, Hhd^Fdf, Gll^Fdf, Gll^Fdf, Gll, Gd, Gd, Gd, Gd, Gd, Gd, Gd, Gd, Wo, Wo, Gd, Gd, Gd, Gd, Gd, Gd, Gd, Gd, Gd, Gd, Gd, Gd, Gd, Gd, Gd, Gd, Gd, Gd, Gd, Gd, Gll^Fdf, Gll^Fdf, Gll^Fdf, Gll^Fdf, Gll^Fdf, Gll^Fdf, Gd, Gd, Gd, Gd, Gd, Gd, Gd, Gd, Gd, Gd, Gll^Fdf, Gll^Fdf, Gll^Fdf, Gll^Fdf, Gll^Fdf, Gll^Fdf, Hhd^Fdf, Gll^Fdf, Gll^Fdf, Gll^Fdf, Gll^Fdf, Gll^Fdf, Gd, Gd, Gd, Gd^Es, Gd, Gd, Gd, Hhd, Hhd^Fdf, Hhd^Fdf, Hhd^Fdf, Hhd^Fdf, Hhd^Fdf, Hhd^Fdf, Hhd^Fdf, Hhd, Hhd, Gd, Gd, Gd, Gd, Gd, Gd, Gd, Gd, Gd, Gd, Gd, Gd, Gd, Gd, Gd, Gd, Gd, Gd, Gd, Gd
Gd, Gd, Gll, Gd, Gd, Gll, Gll, Gd, Gd, Gd, Re^Vct, Gd, Gd, Gll, Gll^Fdf, Gll^Fdf, Hhd^Fdf, Hhd^Fdf, Hhd^Fdf, Hhd^Fdf, Hhd^Fdf, Gll^Fdf, Gll^Fdf, Gd, Gd, Gd, Gd, Gd, Gd, Gd, Gd, Wo, Wo, Gd, Gd, Gd, Gd, Gd, Gd, Gd, Gd, Gd, Gd, Gd, Gd, Gd, Gd, Gd, Gd, Gd, Gd, Gd^Es, Gd, Gd, Gd, Gd, Gd, Gll^Fdf, Gd, Gd, Gd, Gd, Gd, Gd, Gd, Gd, Gd, Gd, Gd, Gd, Gd, Gll^Fdf, Gll^Fdf, Gll^Fdf, Gll^Fdf, Gll^Fdf, Gll^Fdf, Gll^Fdf, Gll^Fdf, Gll^Fdf, Gd, Gd, Gd, Gd, Gd, Gd, Gd, Gd, Hhd, Hhd, Hhd, Hhd^Fdf, Hhd, Hhd^Fdf, Hhd, Hhd, Hhd, Hhd, Gd, Gd, Gd, Gd, Gd, Gd, Gd, Gd, Gd, Gd, Rb^Gvs, Gd, Gd, Gd, Gd, Gd, Gd, Gd, Gd, Gd
Gd, Gd, Gll, Re^Vct, Gd^Es, Gd, Gd, Gd, Gd, Gd, Gd, Gd, Gll, Gll^Fdf, Gll^Fdf, Gll^Fdf, Hhd^Fdf, Hhd^Fdf, Hhd^Fdf, Hhd^Fdf, Hhd^Fdf, Gll^Fdf, Gll^Fdf, Gll, Gd, Gd, Gd, Gd, Gd, Gd, Wo, Wo, Wo, Gd, Gd, Gd, Gd, Gd, Gd, Gd, Gd, Gd, Gd, Gd, Gd, Gd, Gd, Gd, Gd, Gd, Gd, Gd, Gd, Gd, Gd, Gd, Gd, Gd, Gd, Gd, Gd, Gd, Gd, Gd, Gd, Gd, Gd, Gd, Gd, Gd, Gd, Gd, Gd, Gll^Fdf, Gll^Fdf, Gll^Fdf, Gll^Fdf, Gd, Gd, Gd, Gd, Gd, Gd, Gd, Gd, Gd, Gd, Gd, Gd, Hhd, Hhd, Hhd, Hhd, Hhd, Hhd, Hhd, Gd, Gd, Gd, Gd, Gd, Gd, Gd, Gd, Gd, Gd, Rb^Gvs, Rb^Gvs, Rb^Gvs, Rb^Gvs, Rb^Gvs, Gd, Gd, Gd, Gd, Gd, Gd, Gd
Re, Gd, Gd, Gd, Gd, Gd, Ce, Ce, Ce, Gd, Gd, Gd, Gll, Gll^Fdf, Gll^Fdf, Gll^Fdf, Gll^Fdf, Hhd^Fdf, Gll^Fdf, Hhd^Fdf, Gll^Fdf, Gll^Fdf, Gll, Gll, Gd, Gd, Gd, Gd, Gd, Wo, Wo, Wo, Gd, Gd, Gd, Gd, Gd, Gd, Gd, Gd, Gd, Gd, Gd, Gd, Re, Gd, Gd, Gd, Gd, Gd, Gd, Gd, Gd, Gd, Gd, Gd, Gd, Gd, Gd, Gd, Gd, Gd, Gd, Gd, Gd, Gd, Gd, Gd, Gd, Gd, Gd, Gd, Gd, Gd, Gd, Gll^Fdf, Gd, Gd, Gd, Gd, Gd, Gd, Gd, Gd, Gd, Gd, Gd, Gd, Gd, Gd, Gd, Hhd, Gd, Hhd, Gd, Gd, Gd, Gd, Gd, Gd, Gd, Gd, Gd, Gd, Rb^Gvs, Gd, Gd, Rb^Gvs, Rb^Gvs, Rb^Gvs, Gd, Gd, Gd, Gd, Gd, Gd, Gd, Gd
Gd, Re, Re, Gd, Gd, Gd, Ce, Ke, Ce, Gd, Gd, Gd^Es, Gd, Gll, Gll, Gll^Fdf, Gll^Fdf, Gll^Fdf, Gll^Fdf, Gll^Fdf, Gll^Fdf, Gll^Fdf, Gll, Gd, Gd, Gd, Gd, Gd, Gd, Wo, Wo, Gd, Gd, Gd, Re, Gd, Gd, Gd, Gd, Gd, Re, Re, Re, Re, Gd, Re, Re, Gd, Gd, Gd, Gd, Gd, Gd, Gd, Gd, Gd, Gd, Gd, Gs^Vc, Gd, Gd, Gd, Gd, Gd, Gd, Gd, Gd, Gd, Gs^Vc, Gd, Gd, Gd, Gd, Gd, Gd, Gd, Gd, Gd, Gd, Gd, Gd, Gd, Gd, Gd, Gd, Gd, Gd, Gd, Gd, Gd, Gd, Gd, Gd, Gd, Gd, Gd, Gd, Gd, Gd, Gd, Gd, Gd, Rb^Gvs, Rb^Gvs, Rb^Gvs, Rb^Gvs, Rb^Gvs, Gd, Gd, Gd, Gd, Gd, Gd, Gd, Gd, Gd, Gd, Gd
Re, Re, Gd, Re, Gd, Gd, Gd, Ce, Gd, Gd, Gd, Gd^Es, Gd, Gd, Gd, Gll^Fdf, Gll^Fdf, Gll^Fdf, Gd, Gll, Gd, Gll, Gll, Gd, Gd, Gd, Gd, Gd, Rb^Gvs, Wo, Wo, Wo, Ww^Bw/, Re, Gd, Re, Re, Gd, Re, Re, Gd, Gd, Gd, Gd, Gd, Gd, Gd, Re, Re, Re, Re, Gd, Gd, Gd, Gd, Gd, Gd, Gd, Gd, Gd, Gd, Gd, Gd, Gd, Gd, Gd, Rb^Gvs, Gd, Gd, Gd, Gd, Gd, Gs^Vc, Gd, Gd, Gd, Gd, Gd, Gd, Gd^Es, Gd, Gd, Gd, Gd, Gd^Es, Gd, Gd, Gd, Gd, Gd, Gd, Gd, Gd, Gd, Gd, Gd, Gd, Gd, Gd, Gd, Gd, Gd, Gd, Rb^Gvs, Rb^Gvs, Rb^Gvs, Gd, Gd, Gd, Gd, Gd, Gd, Gd, Gs^Vc, Gd, Gd, Gd, Gd
Gd, Gd, Gll, Gd, Re^Vct, Re, Re, Gd, Gd, Gd, Gd, 1 Gd, Gd, Gd, Gll, Gll^Fdf, Gll^Fdf, Gll^Fdf, Gll, Gll, Gd, Gd, Gd, Gd, Gd, Gd^Es, Rb^Gvs, Rb^Gvs, Rb^Gvs, Rb^Gvs, Re, Ww^Bw/, Wo, Gd, Gd, Gd, Gd, Re, Gd, Gd, Gd, Gd, Gd, Gd, Gd, Gd, Gd^Es, Gd, Gd, Gd, Gd, Re, Re, Gd, Gd, Gd, Gd, Gd^Es, Gd, Gd, Gd, Gd, Gd, Gd, Gd, Rb^Gvs, Rb^Gvs, Rb^Gvs, Gd, Gd, Gd, Gd, Rb^Gvs, Rb^Gvs, Gd, Gd, Gd, Gd, Gd, Gd, Gd, Gd, Gd, Gd, Gd, Gd, Gd, Gd, Gd, Gd, Gd, Gd, Gd, Gd, Gd, Gd, Gd, Gd, Gd, Gd, Gd, Gd, Gd, Gd, Gd, Gd, Gd, Gd, Gd, Gd, Gd, Gd, Gd, Gd, Gd, Gd, Gd, Gd
Gd, Gll, Gll, Gll, Gd, Gd, Gd, Re, Re, Gd^Es, Gd, Gd, Gd, Gd, Gll, Gll, Gd, Gll, Gll, Gd, Gd, Gd, Gd, Gd, Gd, Gd, Re, Rb^Gvs, Rb^Gvs, Rb^Gvs, Re, Wo, Wo, Gd, Gd, Gd, Gd, Re, Gd, Gd, Gd, Gd, Gd^Es, Gd, Gd, Gd, Gd, Gd, Gd, Gd, Gd, Gd, Re, Gd, Gd, Gd, Gd, Gd, Gd, Gd, Gd, Gd, Gd, Gd, Gd, Gd, Gd, Gd, Gd, Gd, Gd, Gd, Gd, Gd, Gd, Gd, Gd, Gd, Gd, Gd, Gd, Gd, Gd, Gd, Gd, Gd, Gd, Gd, Gd, Gd, Gd, Gd, Gd, Gd, Gd, Gd, Gd, Gd, Gd, Gd, Gd, Gd, Gd, Gd, Gd, Gs^Vc, Gd, Gd, Gd, Gd, Gd, Gd, Gd, Gd, Gd, Gd, Gd, Gd
Gll^Fdf, Gll^Fdf, Gll^Fdf, Gd, Gll, Gd, Gd, Gd, Gd^Es, Re, Gd, Gd, Gd, Gd, Gd, Gd, Gd, Gd, Gd, Gd, Gd, Gd, Gd, Gd, Re, Re, Gd, Re, Re, Re, Gd, Wo, Wo, Gd, Gd, Gd, Gd, Re, Gd, Gd, Gd, Gd, Gd, Gd, Gd, Gd, Gd, Gd, Gd, Gd, Gd, Gd, Re, Gd, Gd, Gd, Gd, Gd, Gd, Gd, Gd, Gd, Gd, Gs^Vc, Gd, Gd, Gd, Gd, Khr, Chr, Gd, Gd, Gd, Gd, Gd, Gd, Gd, Gd, Gd, Gd, Gd, Gd, Gd^Es, Gd, Gd, Gd, Gd, Gd, Hhd, Hhd, Hhd, Gd, Gd, Gd, Gd, Gd, Gd, Gd, Gd, Gd, Gd, Gd, Gd, Gd, Gd, Gd, Gd, Gd, Gd, Gd, Gd, Gd, Gd, Gd, Gs^Vc, Gd, Gd, Gd
Gll^Fdf, Gll^Fdf, Gll^Fdf, Gll, Gll, Gd, Gll, Gd, Gd, Gd, Re, Gd, Gs^Vc, Gd, Gd, Gd, Gd, Gd, Gd, Gd, Gd, Gd, Gd, Re, Gd, Gd, Gs^Vc, Gd, Gd, Gd, Wo, Wo, Wo, Gd, Gd, Gd, Re, Re, Gd, Gd, Gd, Gd, Gd, Gd, Gd, Gd, Gll^Fdf, Gd, Gd, Gd, Gd, Gd, Gd, Re, Re, Gd, Gd, Gd, Gd, Gd, Gd, Gd, Gd, Gd, Gd, Gd, Gd, Chr, Chr, Chr, Gd, Gd, Re, Re, Re, Gd, Gd, Gd, Gd, Gd, Gd, Gd, Gd, Gd, Gd, Gd, Hhd, Hhd, Hhd, Hhd, Hhd, Hhd, Gd, Gd, Gd, Gd, Gd, Gd, Gd, Gd, Gd, Gd, Gd, Gd, Gd, Gd, Gd, Gd, Gd, Gd, Gd, Gd, Gd, Gd, Gd, Gd, Gd, Gd
Gll^Fdf, Gll^Fdf, Gll^Fdf, Gll^Fdf, Gll^Fdf, Gll, Gd, Gd, Gd, Gd, Re, Gd, Gd, Gd, Gd, Gd, Gd, Gd, Gs^Vc, Gd, Gd, Gd, Ce, Re, Gd, Gd, Gd, Gd, Gd, Wo, Wo, Wo, Gd, Gd, Re, Re, Gd, Gd, Gd, Gd, Gd, Gd, Gd, Gd, Gd, Gll^Fdf, Gll^Fdf, Gll^Fdf, Gd, Gd, Gd, Gd, Gd, Gd, Gd, Re, Re, Gd, Re, Gd, Gd, Gd, Gd, Gd, Gd, Gd, Gd, Gd, Re, Gd, Re, Re, Gd, Gd, Gd, Re, Re, Gd, Gd, Gd, Gd, Gd, Gd, Gd, Gd, Gd, Hhd, Hhd, Hhd, Hhd, Hhd, Hhd, Gd, Gd, Gd, Gd, Gd, Gd, Gd, Gd, Gd, Gd, Gd, Gd, Gd, Gd, Gd, Gd, Gd, Gd, Ce, Ce, Ce, Gd, Gd, Gd, Gd, Gd
Gll^Fdf, Gll^Fdf, Gll^Fdf, Gll^Fdf, Gll^Fdf, Gll^Fdf, Gll, Gll, Gd, Gd, Re, Gd, Gd, Gd, Gd, Gd, Gd, Gd, Gd, Gd, Ce, Gd, Re, Re, Ce, Gd, Gd, Gd, Gd, Wo, Wo, Gd, Gd, Re, Gd, Gd, Gd, Gd, Gd, Gd, Gd, Gd, Gd, Gd, Gd, Gll^Fdf, Gll^Fdf, Gll^Fdf, Gll^Fdf, Gd, Gd, Gd, Gd, Gd, Gd, Gd, Gd, Re, Gd, Re, Re, Re, Re, Re, Re, Re, Re, Re, Gd, Re, Chr, Gd, Gd, Gd, Gd, Gd, Gd, Re, Re, Gd, Gd, Gd, Gd, Gd, Gd, Gd, Hhd, Hhd, Hhd, Hhd, Hhd, Hhd, Hhd, Gd, Gd, Gd, Gd, Gd, Gd, Gd, Gd, Gd, Gd, Gd, Re, Gd, Gd, Gd, Ket, Ce, Re, Re, Re, Ce, Ce, Gd, Gd, Gd
Gll^Fdf, Gll^Fdf, Gll^Fdf, Gll^Fdf, Gll^Fdf, Gll^Fdf, Gll, Gd, Gd, Gd^Es, Gd^Es, Gd, Re, Gd, Gd, Gd, Gd, Gd, Ce, Ket, Re, Re, Gd, Re, Gd, Ket, Ce, Gd, Gd, Wo, Wo, Gd, Gd, Re, Gd, Gd^Es, Gd, Gd, Gd, Gd, Gd, Gd, Gd, Gd, Gd, Gd, Gll^Fdf, Gll^Fdf, Gll^Fdf, Gd, Gd, Gd, Gd, Gd, Gd, Gd, Gd, Gd, Gd, Gd, Gd, Gd, Gd, Gd, Gd, Gd, Gd, Gd, Gd, Chr, Khr, Chr, Gd, Gd, Gs^Vc, Gd, Gd, Gd, Gd, Re, Re, Gd, Gd, Gd, Gd, Gd, Hhd, Hhd, Hhd, Hhd, Hhd, Hhd, Gd, Gd, Gd, Gd, Gd, Gd, Gd, Gd, Gd, Gd, Re, Re, Gd, Re, Re, Re, Re, Re, Re, Re, Re, Re, Re, Ce, Gd, Gd
Gll^Fdf, Gll^Fdf, Gll^Fdf, Gll^Fdf, Gll, Gll, Gd, Gd, Gd, Gd, Gd, Gd, Gd^Es, Re, Re, Re, Re, Gd, Re, Gd, Re, Re, Ch, Re, Re, Re, Re, Gd, Gd, Wo, Wo, Gd, Re, Re, Gd, Gd, Gd, Gd, Ww, Gd, Gd, Gd, Gd, Gd, Gd, Gd, Gd, Gll^Fdf, Gd, Gd, Gd, Gd, Gd, Gd, Gd, Gd, Gd^Es, Gd, Gd, Gd, Hhd, Gd, Gd, Gd, Gd, Gd, Gd, Gd, Gd, Chr, Gd, Gd, Gd, Gd, Gd, Gd, Gd, Gd, Gd, Gd, Gd, Re, Re, Gd, Gd, Gd, Gd, Hhd, Gd, Hhd, Gd, Gd, Gd, Gd, Gd, Gd, Gd, Gd, Gd, Gd, Gd, Re, Gd, Gd, Gd, Gd, Gd, Re, Re, Re, Ch, Ch, Ch, Re, Re, Ce, Gd, Gd
Gll, Gll^Fdf, Gll, Gll, Gll, Gd, Gd, Gd, Gd, Gd, Gd, Gd, Gd^Es, Gd, Gd, Gd, Gd, Re, Ce, Re, Gd, Ch, Kh, Ch, Gd, Re, Ce, Re, Gd, Wo, Ww^Bw/, Re, Gd, Gd, Gd, Gd, Ww, Wwr, Wwr, Ww, Ww, Gd, Gd, Gd, Gd, Gd, Gd, Gd, Gd, Gd, Gd, Gd, Gd, Gd, Gd, Gd^Es, Gd^Es, Gd^Es, Hhd, Hhd, Hhd, Hhd, Hhd, Gd, Gd, Gd, Gs^Vc, Gd, Gd, Gd, Gd, Gd, Gd, Gd, Gd, Gd, Gd, Gd, Gd, Gd, Gd, Gd, Gd, Re, Re, Gd, Re, Gd, Re, Gd, Gd, Gd, Re, Gd, Gd, Gd, Gd, Gd, Gd, Gd, Gd, Re, Gd, Gd, Gd, Gd, Gd, Ket, Re, Re, Ch, Kh, Ch, Re, Re, Ce, Gd, Gd
Gd, Gll^Es, Gd, Gll, Gd, Gd, Gd, Gd, Gd, Gd, Gd, Gd, Gd^Es, Gd, Gd, Gd, Gd, Gd, Ce, Re, Re, Ch, Ch, Ch, Re, Re, Ce, Re, Re, Ww^Bw/, Wo, Wo, Wo, Gd, Ww, Wwr, Ww, Ww, Gd^Es, Ww, Ww, Wwr, Ww, Gd, Gd, Gd, Gd, Gd, Gd, Gd, Gd, Gd, Gd, Gd, Gd, Gd^Es, Gd^Es, Gd, Gd^Es, Hhd, Hhd, Hhd, Hhd, Gd, Gd, Gd, Gd, Gd, Gd, Gd, Gd, Gd, Gs^Vc, Gd, Gd, Gd, Gd, Gd, Gd, Gd, Gd, Gd, Gd, Gd, Gd, Re, Gd, Re, Gd, Re, Re, Re, Gd, Re, Re, Gd, Gd, Gd, Re, Gd, Re, Re, Gd, Gd, Gd, Gd, Gd, Ce, Re, Re, Re, Ch, Re, Re, Re, Ce, Gd, Gd
Gd, Gd, Gd, Gd, Gd, Gd^Es, Gd, Gd, Gd, Gd, Gd, Gd^Es, Gd, Gd, Gd, Gd, Gd, Gd, Gd, Gd, Re, Re, Gd, Re, Re, Re, Gd, Gd, Gd, Gd, Gd, Wo, Ww, Ww, Wwr, Wwr, Gd^Efm, Gd^Efm, Gd^Efm, Gd^Efm, Gd, Wwr, Ww, Ww, Ww, Gd, Gd, Gd, Gd, Gd, Gd, Gd, Gd, Gd, Gd, Gd, Gd, Gd^Es, Gd, Hhd, Hhd, Hhd, Gd, Gd, Gd, Gd, Gd, Gd, Gd, Gd, Gd, Gd, Gd, Gd, Gd, Gd, Gd, Gd, Gd, Gd, Gd, Gd, Gd, Gd, Gd, Gd, Gd, Gd, Gd, Gd, Gd, Gd, Gd, Gd, Re, Gd, Re, Re, Gd, Re, Gd, Gd, Gd, Gd, Gd, Gd, Gd, Ce, Ce, Re, Re, Re, Re, Re, Ce, Ce, Gd, Gd
Gd, Gd, Gd, Gd, Gd, Gd, Gd, Gd^Es, Gd^Es, Gd, Gd, Gd, Gd, Gd, Gd, Gs^Vc, Rb^Gvs, Gd, Gd, Ce, Ket, Re, Re, Re, Ket, Ce, Gd, Gd, Gd, Gd, Gd, Ww, Wwr, Ww, Gd^Efm, Gd^Efm, Gd^Efm, Gd, Gd^Efm, Gd^Efm, Gd, Gd, Gd, Wwr, Wwr, Ww, Ww, Gd, Gd, Gd, Gd, Gd, Gd, Gd, Gd, Gd, Gd, Gd, Gd, Gd, Gd, Gd, Gd, Gd, Gd, Gd, Gd, Gd, Gd, Gd, Gd, Gd, Gd, Gd, Gd, Gd, Gd, Gd, Gd, Gd, Gd, Gd, Gd, Gd, Gd, Gd, Hhd, Gd, Hhd, Gd, Hhd, Gd, Gd, Gd, Gd, Re, Re, Gd, Gd, Gd, Rb^Gvs, Gd, Gd, Gs^Vc, Gd, Gd, Gd, Gd, Gd, Ce, Ce, Re, Ce, Ce, Gd, Gd, Gd, Gd
Gd, Gd, Gd, Gd, Gd, Gd, Gd, Gd, Gd, Gd, Gd, Gd, Gd, Gd, Gd, Rb^Gvs, Gd, Gd, Gd, Gd, Gd, Ce, Re, Ce, Gd, Gd, Gd, Gd, Gd, Gs^Vc, Gd, Wwr, Ww, Gd^Efm, Gd, Gd, Gd^Efm, Gd^Efm, Gd^Efm, Gd^Efm, Gd, Gd, Gd, Gd, Gd, Ww, Ww, Wo, Wo, Gd, Gd, Gd, Gd, Gd, Gd, Gd, Gd, Gd, Gd, Gd, Gd, Gd, Gd, Gd, Gd, Gd, Gd, Gd, Gd, Gd, Gd, Gd, Gd, Gd, Gd, Gd, Gd, Gd, Gd, Gd, Gd, Gd, Gd, Gd, Hhd, Hhd, Hhd, Hhd, Hhd, Hhd, Hhd, Hhd, Hhd, Gd, Gd, Gd, Re, Gd, Rb^Gvs, Rb^Gvs, Rb^Gvs, Rb^Gvs, Rb^Gvs, Gd, Gd, Gd, Gd, Gd, Gd, Gd, Gd, Ce, Gd, Gd, Gd, Gd, Gd, Gd
Gd, Gd, Gd, Gd, Gll, Gd, Gll, Gd, Gll, Gd, Gll, Gd, Gd, Gd^Es, Gd^Es, Gd, Gd, Gd, Re, Gd, Re, Re, Gd, Gd, Gd, Gd, Gd, Gd, Gd, Gd, Gd, Ww, Wwr, Gd^Efm, Gd, Gd^Efm, Gd^Efm, Gd, Gd^Efm, Gd^Efm, Gd^Efm, Gd, Gd, Gd, Gd, Gd, Gd, Wo, Wo, Wo, Wo, Gd, Gd, Gd, Gd, Gd, Gd, Gd, Gd, Gd, Gd, Gd, Gd, Gd, Gd, Gd, Gll^Fdf, Gll, Gll, Gd, Gd, Gd, Gd, Gd, Gd, Gd^Es, Gd, Gd, Gd, Gd, Gd, Gd, Hhd, Hhd, Hhd, Hhd, Hhd^Fdf, Hhd^Fdf, Hhd^Fdf, Hhd^Fdf, Hhd^Fdf, Hhd, Hhd, Gd, Gd, Gd, Re, Gd, Gd, Rb^Gvs, Rb^Gvs, Rb^Gvs, Gd, Gd, Rb^Gvs, Gd, Gd, Gs^Vc, Gd, Gd, Gd, Gd, Gd, Gd, Gd, Gd, Gd, Gd
Gd, Gd, Gd, Gll, Gll^Fdf, Gll^Fdf, Gll^Fdf, Gll^Fdf, Gll^Fdf, Gll^Fdf, Gll^Fdf, Gll, Gd, Gd, Gd^Es, Gd, Re, Re, Gd, Re, Gd, Gd, Gd, Gd, Gd, Gd, Gs^Vc, Gd, Gd, Gd, Gd^Es, Ww, Ww, Gd^Efm, Gd^Efm, Gd^Efm, Gd^Efm, Gd^Efm, Gd^Efm, Gd, Gd^Efm, Gd, Gd, Gd, Gd, Gd, Gd, Gd, Gd, Wo, Wo, Wo, Wo, Gd, Gd, Gd, Gd, Gd, Gd, Gd, Gd, Gd, Gll^Fdf, Gd, Gll, Gll^Fdf, Hhd^Fdf, Gll^Fdf, Gd, Gd, Gd, Gd, Gd, Gd, Gd, Gd, Gd, Gd, Gd, Gd, Gd, Gd, Hhd, Hhd, Hhd^Fdf, Hhd^Fdf, Hhd^Fdf, Hhd^Fdf, Hhd^Fdf, Hhd^Fdf, Hhd^Fdf, Hhd, Hhd, Gd, Gd, Gd, Re, Gd, Gd, Gd, Gd, Gd, Rb^Gvs, Rb^Gvs, Rb^Gvs, Rb^Gvs, Rb^Gvs, Gd, Gd, Gd, Gd, Gd, Gd, Gd, Gd, Gd, Gd, Gd
Gd, Gd, Gd, Gd, Gll^Fdf, Gll^Fdf, Gll^Fdf, Gll^Fdf, Gll^Fdf, Gll^Fdf, Gll^Fdf, Gll^Fdf, Gll, Gd, Gd, Re, Gd, Gd, Gd, Gd, Rb^Gvs, Rb^Gvs, Rb^Gvs, Gd, Gd, Gd, Gd, Gd, Gd, Gd, Gd, Wwr, Wwr, Gd^Efm, Gd^Efm, Gd, Gd^Efm, Gd, Gd, Gd^Efm, Gd, Gd, Gd, Gd, Gd, Gd, Gd, Gd, Gd, Gd, Gd, Wo, Wo, Wo, Gd, Gd, Gd, Gd, Gd, Gd, Gd, Gll^Fdf, Gll^Fdf, Gll, Gll, Gll^Fdf, Gll^Fdf, Gll^Fdf, Gd, Gd, Gd, Gd, Gd, Gd, Gd, Gd, Gd, Gd, Gd, Gd, Gd, Gd, Hhd, Hhd, Hhd^Fdf, Hhd^Fdf, Md, Md, Md, Hhd^Fdf, Hhd^Fdf, Hhd, Hhd, Gd, Gd, Gd, Re, Re, Re, Gd, Gd, Gd, Gd, Rb^Gvs, Rb^Gvs, Rb^Gvs, Gd, Gd, Gd, Gd, Gd, Gs^Vc, Gd, Gd, Gd, Gd, Gd, Gd
Gd, Gd, Gd, Gll, Gll^Fdf, Gll^Fdf, Gll^Fdf, Gll^Fdf, Gll^Fdf, Gll^Fdf, Gll^Fdf, Gll^Fdf, Gll, Gd, Gd, Re, Gd, Gs^Vc, Gd, Rb^Gvs, Rb^Gvs, Rb^Gvs, Rb^Gvs, Rb^Gvs, Wo, Gd, Gd, Gd, Gd, Gd, Ww, Ww, Wwr, Gd^Efm, Gd^Efm, Gd^Efm, Gd, Gd^Efm, Gd^Efm, Gd^Efm, Gd, Gd, Gd, Gd, Gd, Gd, Gd, Gd, Gd, Gd, Gd, Gd, Wo, Wo, Gd, Gd, Gd, Gd, Gd, Gd, Gll, Gll^Fdf, Hhd^Fdf, Gll^Fdf, Gd, Gll, Gll, Gll^Fdf, Gd, Gd, Gd, Gd, Gd, Gd, Gd, Gd, Gd, Gd, Gd, Gd, Gd, Gd, Hhd, Hhd, Hhd^Fdf, Hhd^Fdf, Hhd^Fdf, Md, Hhd^Fdf, Hhd^Fdf, Hhd^Fdf, Hhd, Hhd, Gd, Gd, Gd, Re, Gs^Vc, Gd, Re, Re, Gd, Gd, Gd, Gd, Gd, Gd, Gd, Gd, Gd, Gd, Gd, Gd, Gd, Gd, Gd, Gd, Gd
Gd, Gd, Gd, Gll^Fdf, Gll^Fdf, Gll^Fdf, Gll^Fdf, Gll^Fdf, Gll^Fdf, Gll^Fdf, Gll^Fdf, Gll^Fdf, Gd, Gd, Gd, Re, Re, Gd, Re, Re, Re, Rb^Gvs, Wo, Wo, Wo, Ww, Ww, Gd, Ww, Ww, Wwr, Wwr, Gd, Gd, Gd^Efm, Gd^Efm, Gd, Gd^Efm, Gd, Gd^Efm, Gd, Gd, Gd, Gd, Gd, Gd^Es, Gd, Gd, Gd, Gd, Gd, Gd, Wo, Wo, Gd, Gd, Gd, Gd, Gd, Gd, Gll, Gll^Fdf, Hhd^Fdf, Gll^Fdf, Gll^Fdf, Gll, Gll, Gll, Gd, Gd, Gd, Gd, Gd, Gd, Gd, Gd, Gd, Gd, Gd, Gd, Gd, Gd, Gd, Hhd, Hhd, Hhd^Fdf, Hhd^Fdf, Hhd^Fdf, Hhd^Fdf, Hhd^Fdf, Hhd, Hhd, Hhd, Gd, Re, Re, Gd, Gd, Gd, Gd, Gd, Re, Re, Gd, Ce, Ce, Ce, Gd, Gd, Gd, Gd, Gd, Gd, Gd, Gd, Gd, Gd, Gd
Gll, Gd, Gll, Gll^Fdf, Gll^Fdf, Gll^Fdf, Gll^Fdf, Gll^Fdf, Gll^Fdf, Gll^Fdf, Gll^Fdf, Gll^Fdf, Gll, Gd, Gd, Gd, Gd, Re, Gd, Gd, Wo, Ww^Bw\, Ww^Bw\, Wo, Gd, Ww, Ww, Ww, Ww, Ww, Gd, Gd, Gd, Gd^Efm, Gd, Gd, Gd^Efm, Gd, Gd^Efm, Gd^Efm, Gd, Gd, Gd, Gd, Gd, Gd, Gd, Gd, Gd, Gd, Gd, Gd, Wo, Wo, Gd, Gd, Gd, Gd, Gd, Gd, Gll, Gll^Fdf, Gll^Fdf, Hhd^Fdf, Gll^Fdf, Gll^Fdf, Gll, Gd, Gd, Gd, Gd, Gd, Hhd, Gd, Gd, Gd, Gd, Gd, Gd, Gd, Gd, Gd, Gd, Hhd, Hhd, Hhd, Hhd, Hhd^Fdf, Hhd, Hhd, Hhd, Hhd, Gd, Gd, Re, Gd, Gd, Gd, Gs^Vc, Gd, Gd, Re, Re, Ket, Gll, Gll, Gll, Ce, Ce, Gd, Gd, Gd, Gd, Gs^Vc, Gd, Gd, Gd, Gd
Gll, Gd, Gd, Gd, Gll, Gll, Gll, Gll^Fdf, Gll^Fdf, Gll^Fdf, Gll^Fdf, Gll^Fdf, Gd, Gll, Gd, Gd, Gd, Gd, Wo, Wo, Wo, Wo, Gd, Re, Re, Gd, Gd, Ww, Gd^Es, Gd, Gd, Gd, Gd, Gd, Gd, Gd, Gd, Gd^Efm, Gd, Gd, Gll^Fdf, Gll^Fdf, Gll^Fdf, Gd, Gd, Gd, Gd, Gd, Gd, Gd, Gd, Gd, Wo, Wo, Gd, Gd, Gd, Gd, Gd, Gd, Gd, Gll, Gd, Gll^Fdf, Gd, Gd, Gd, Gd, Gd, Gd, Gd, Hhd, Hhd, Hhd, Hhd, Gd, Gd, Gd, Gd, Gd, Gd, Gd, Gd, Gd, Gd, Hhd, Hhd, Hhd, Hhd, Hhd, Gd, Gd, Gd, Gd, Re, Gd, Gd, Gd, Gd, Gd, Ce, Ket, Gll, Re, Re, Gll^Fdf, Gll^Fdf, Gll, Gll, Ce, Gd, Gd, Gd, Gd, Gd, Gd, Gd, Gd
Gd, Gll, Gll, Gd, Gd, Gd, Gd, Gd, Gd, Gll^Fdf, Gd, Gll, Gd, Gd, Gd^Es, Gd, Gd, Gd, Wo, Wo, Gd, Gd, Gd, Gd, Gd, Gd, Gd, Gd, Gd, Gd, Gd, Gd, Gd, Gd^Es, Gd, Gd, Gd, Gd, Gd, Gll^Fdf, Hhd^Fdf, Hhd^Fdf, Hhd^Fdf, Gll^Fdf, Gll^Fdf, Gd, Gd, Gd, Gd, Gd, Gd, Gd, Wo, Wo, Gd, Gd, Gd, Gd, Gd, Gd, Gd, Gd, Gd, Gd, Gd, Gd, Gd, Gd, Gd, Gd, Hhd, Hhd, Hhd^Fdf, Hhd^Fdf, Hhd^Fdf, Hhd, Gd, Gd, Gd, Gd, Gd, Gd, Gd, Gd, Gd, Gd, Gd, Gd, Gd, Gd, Gd, Gd, Re, Re, Gd, Gd, Gd, Gd, Gd, Gd, Ce, Gll, Gll^Fdf, Re, Hhd, Hhd, Hhd, Gll^Fdf, Gll, Ce, Gd, Gd, Gd, Gd, Gd, Gd, Gd, Gd
Gd, Gd, Gd, Gd, Gd, Gd, Gll, Gd, Gd, Gll, Gd, Gd, Gll, Gd, Gll, Gd, Gd, Gd, Ww, Wo, Gll^Fdf, Gll^Fdf, Gll^Fdf, Gd, Gd, Gd, Gd, Re, Gd, Gd, Gd, Gd, Gd, Gd, Gd, Gd, Gd, Gd, Gd, Gll^Fdf, Hhd^Fdf, Hhd^Fdf, Hhd^Fdf, Hhd^Fdf, Hhd^Fdf, Gll^Fdf, Gd, Gd, Gd, Gd^Es, Gd, Gd, Wo, Wo, Wo, Gd, Gd, Gd, Gd, Gd, Gd, Gd, Gd, Gd, Gd, Gd, Gd, Gd, Gd, Hhd, Hhd, Hhd^Fdf, Hhd^Fdf, Hhd^Fdf, Hhd^Fdf, Hhd, Hhd, Gd, Gd, Gd, Gd, Gd, Gd, Gd, Gd, Gd, Gd, Gd, Gd, Gd, Gd, Gd, Re, Gd, Gd, Gd, Gd, Gd, Gd, Gd, Ce, Gll, Gll^Fdf, Hhd, Ch, Ch, Ch, Hhd, Gll, Ce, Gd, Gd, Gd, Gd, Gs^Vc, Gd, Gd, Gd
Gd, Gd, Gd, Gd, Gd, Gd, Gd, Gll^Es, Gd, Gd, Gd, Gd, Gll^Fdf, Gll^Fdf, Gll^Fdf, Gll, Gd, Gll, Ww, Ww, Gll^Fdf, Gll^Fdf, Gll^Fdf, Gd, Gd, Gd, Gd, Re, Re, Gd, Gd, Gd, Gd, Gd, Gd, Gd, Gd, Gd, Gd, Gll^Fdf, Hhd^Fdf, Hhd^Fdf, Hhd^Fdf, Hhd^Fdf, Hhd^Fdf, Gll^Fdf, Gd, Gd, Gd, Gd, Gd, Gd, Gd, Wo, Wo, Wo, Ww, Gd, Gd, Gd, Gd, Gd, Gd, Gd, Gd, Gd, Gd, Gd, Gd, Hhd, Hhd, Hhd^Fdf, Hhd^Fdf, Hhd^Fdf, Hhd, Hhd, Hhd, Gd, Gd, Gd, Gd, Gd, Gd, Gd, Gd, Gd, Gd, Gd, Gd, Gd, Gd, Gd, Re, Gd, Rb^Gvs, Rb^Gvs, Rb^Gvs, Gd, Gd, Gd, Ce, Gll, Gll^Fdf, Hhd, Ch, Kh, Ch, Hhd, Gll, Ce, Gd, Gd, Gd, Gd, Gd, Gd, Gd, Gd
Gd, Gd, Gd, Gd, Gd, Gd, Gd, Gd, Gd, Gd, Gd, Gll, Gll^Fdf, Gll^Fdf, Gll^Fdf, Gll^Fdf, Gll^Fdf, Gd, Wo, Ww, Gd, Gll^Fdf, Gd, Gd, Gd, Gd, Gd, Gd, Gd, Gd, Re, Gd, Gd, Gd, Gd^Es, Gd, Gd, Gd, Gd, Gll^Fdf, Gll^Fdf, Hhd^Fdf, Hhd^Fdf, Hhd^Fdf, Gll^Fdf, Gll^Fdf, Gd, Gd, Gd, Gd, Gd, Gd, Gd, Gd, Gd, Ww, Ww, Ww, Gd, Gd, Gd, Gd, Gd, Gd, Gd, Gd, Gd, Gd, Gd, Gd, Hhd, Hhd, Hhd, Hhd, Gd, Hhd, Gd, Gd, Gd, Gd, Gd, Gd, Gd, Gd, Gd, Gd, Gd, Gd, Gd, Gd, Gs^Vc, Gd, Re, Rb^Gvs, Rb^Gvs, Rb^Gvs, Rb^Gvs, Rb^Gvs, Gd, Gd, Ce, Gll, Gll, Hhd, Hhd, Ch, Hhd, Hhd, Hhd^Fdf, Ce, Gll^Fdf, Gd, Gd, Gd, Gd, Gd, Gd, Gd
Gd, Gd, Gd, Gd, Gd, Gd, Gd, Gll, Gd^Es, Gd, Gd, Gd, Gll, Gll^Fdf, Gll^Fdf, Gll^Fdf, Gll^Fdf, Gll, Wo, Wo, Gd, Gd, Gd, Gd, Gd, Gd, Gd, Gd, Gd, Gd, Re, Gd, Gd, Gd, Gd^Es, Gd, Gd, Gd, Gd, Gd, Gll^Fdf, Gll^Fdf, Gll^Fdf, Gll^Fdf, Gd, Gd, Gd, Gd, Gd, Gd, Gd, Gd, Ss, Gd, Sm, Sm, Ww, Ww, Gd, Gd, Gd, Gd, Gd, Gd, Gd, Gd, Gd, Gd, Gd^Es, Gd, Gd, Hhd, Hhd, Hhd, Gd, Gd, Gd, Gd, Gd, Gd, Gd, Gd, Gd, Gd, Gd, Gd, Gd, Gd, Gd, Gd, Gd, Gd, Re, Gd, Gd, Rb^Gvs, Gd, Gd, Gd, Gd, Gd, Ce, Ce, Hhd, Hhd, Hhd, Hhd^Fdf, Hhd^Fdf, Ce, Hhd^Fdf, Gll^Fdf, Gd, Gd, Gd, Gd, Gd, Gd, Gd
Gd, Gd, Gd, Gd, Gd^Es, Gd, Gd, Gd, Gd, Gd, Gd, Gd, Gll, Gll^Fdf, Gll^Fdf, Gll^Fdf, Gll^Fdf, Gll, Wo, Wo, Gd, Gd, Gd, Gd, Gd, Gd, Gd, Gd, Gd, Gd, Gd, Re, Re, Re, Re, Gd, Gd, Gd, Gd, Gd, Gd, Gd, Gd, Gd, Gd, Gd, Gd, Gd, Gd, Gd, Ss, Ss, Sm, Sm, Sm, Sm, Ww, Ww, Ww^Bw/r, Gd, Gd, Gd, Gd, Gd, Gd, Gd, Gd, Gd, Gd, Gd^Es, Gd, Gd, Gd, Gd, Gd, Gd, Gd, Gd, Gd, Gd, Gd, Gd, Gd, Gd, Gd, Gd, Gd, Gd, Gd, Gd, Gd, Gd, Re, Gd, Gd, Gd, Gd, Gd, Gd, Gd, Gd, Gd, Gll^Fdf, Hhd, Ce, Hhd^Fdf, Ce, Hhd^Fdf, Hhd^Fdf, Hhd^Fdf, Gll^Fdf, Gd, Gd, Gs^Vc, Gd, Gd, Gd, Gd
Gd, Gd, Gd, Gd, Gd, Gd, Gd, Gd, Gd, Gd, Gd, Gd, Gd, Gll^Fdf, Gll^Fdf, Gll^Fdf, Gll, Gd, Wo, Wo, Ww, Gd, Gd, Gd, Gd, Gd, Gd, Gd, Gd, Gd, Gd, Gd, Gd, Gd, Gd, Re, Re, Gd, Gd, Gd, Gd, Gd, Gd, Gd, Gd, Gd, Gd, Gd, Gd, Gd, Ss, Sm, Sm, Sm, Ss, Sm, Ss, Ww^Bw/r, Ww, Ww, Ww, Gd, Gd, Gd, Gd, Gd, Gd, Gd, Gd, Gd, Gd^Es, Gd, Gd, Gd, Gd, Gd, Gd, Gd, Gd, Gd, Gd, Gd, Gd, Gd, Gd, Hhd, Hhd, Gd, Gd, Gd, Gd, Gd, Re, Gd, Gd, Gd, Gd, Gd, Gd, Gd, Gd, Gd, Gll^Fdf, Hhd^Fdf, Hhd^Fdf, Hhd^Fdf, Hhd^Fdf, Hhd^Fdf, Hhd^Fdf, Gll^Fdf, Gd, Gd, Gd, Gd, Gd, Gd, Gd, Gd
Gd, Gd, Gd, Gd, Gd, Gd, Gd, Gd, Gd, Gs^Vc, Gd, Gd, Gd, Gll, Gd, Gd, Gd, Gd, Gd, Ww, Ww, Ww, Ww, Gd, Gd, Gd, Gd, Gd^Es, Gd, Gd, Gd, Gd, Gd, Gd, Gd, Gd, Gd, Gd, Re, Gd, Gd, Gd, Gd, Gd, Gd, Gd^Es, Gd, Gd, Gd, Gd, Ss, Ss^Em, Sm, Sm, Ss^Vhs, Ss^Em, Ss, Ss, Sm, Ww, Ww, Ww, Gd, Gd, Gd, Gd, Gd, Gd, Gd, Gd, Gd, Gd, Gd, Gd, Gd, Gs^Vc, Gd, Gd, Gd, Gd, Gd, Gd, Gd, Gd, Hhd, Hhd, Hhd, Hhd, Hhd, Gd, Gd, Gd, Gd, Re, Re, Gd, Gd, Gd, Gd, Gd, Gd, Gd, Gll^Fdf, Hhd^Fdf, Hhd^Fdf, Hhd^Fdf, Hhd^Fdf, Hhd^Fdf, Gll^Fdf, Gll^Fdf, Gd, Gd, Rb^Gvs, Rb^Gvs, Rb^Gvs, Gd, Gd, Gd
Gd, Gd, Gll, Gd, Gll^Fdf, Gd, Gd, Gd, Gd, Gd, Gd, Gd, Gd, Gd, Gd, Gd, Gd, Gd, Gd, Gd, Gd, Ww, Wo, Wo, Wo, Gd, Gd, Gd, Gd, Gd, Gd, Gd, Gd, Gd, Gd, Gd, Gd, Gd, Gd, Gd, Re, Gd, Gd, Gd, Gd, Gd, Gd, Gd, Gd, Ss, Sm, Sm, Ss, Ss, Ss, Ss, Chs, Chs, Chs, Sm, Sm, Ww, Gd, Gd, Gd, Gd, Gd, Gd, Gd, Gd, Gd, Gd, Gd, Gd, Gd, Gd, Gd, Gd, Gd, Gd, Gd, Gd, Hhd, Hhd, Hhd, Hhd, Md, Hhd, Hhd, Hhd, Hhd, Gd, Gd, Gd, Re, Gd, Gd, Gs^Vc, Gd, Gd, Gd, Gd, Gll^Fdf, Gll^Fdf, Hhd^Fdf, Hhd^Fdf, Gll^Fdf, Gll^Fdf, Gd, Gd, Gd, Rb^Gvs, Rb^Gvs, Rb^Gvs, Rb^Gvs, Rb^Gvs, Gd, Gd
Gll^Fdf, Gll^Fdf, Gll^Fdf, Gll^Fdf, Gll^Fdf, Gll^Fdf, Gd, Gd, Gd, Gd^Es, Gd, Gd, Gd, Gd, Gd, Gd, Gd, Gd, Gd, Gd, Gd, Gd, Gd, Wo, Wo, Wo, Wo, Gd, Gd, Gd, Gd, Gd^Es, Gd, Gd, Gd, Gd, Gd, Gd, Gd, Gd, Gd, Re, Gd, Gd, Gd, Gd, Gd, Gd, Gd, Ss, Sm, Sm, Ss, Ss^Em, Ss, Ss, Chs, Khs, Chs, Sm, Ww, Ww, Gd, Gd, Gd, Gd, Gd, Gd, Gd, Gd, Gd, Gd, Gd, Gd, Gd, Gd, Gd, Gd, Gd, Gd, Gd, Hhd, Hhd, Hhd, Hhd, Md, Md^Xm, Md, Md, Hhd, Hhd, Gd, Gd, Gd, Re, Gd, Gd, Gd, Gd, Gd, Gd, Gd, Gll, Gll^Fdf, Gll^Fdf, Gll^Fdf, Gll, Gd, Gd, Gd, Gd, Gd, Gd, Rb^Gvs, Gd, Gd, Gd, Gd
Hhd, Gll^Fdf, Hhd, Hhd^Fdf, Hhd^Fdf, Gll^Fdf, Gll, Gd, Gd, Gd, Gd, Gd, Gd, Gd, Gd^Es, Gd, Gd, Gd, Gd, Gd, Gd, Gd, Gd, Gd^Es, Gd, Wo, Wo, Wo, Gd, Gd, Gd, Gd, Gd, Gd, Gd, Gd, Gd, Gd, Gd, Gd, Gd, Gd, Gd, Re, Re, Re, Re, Gd, Gd, Gd, Sm, Sm, Sm, Ss, Ss^Vhs, Ss, Ss, Chs, Ss, Ss, Ww, Ww, Gd, Gd, Gd, Gd, Gd, Gd, Gd, Gd, Gd, Gd, Gd, Gd, Gd^Es, Gd, Gd, Gd, Gd, Gd, Hhd, Hhd, Hhd, Hhd, Md, Md, Md^Xm, Md^Xm, Md, Hhd, Hhd, Hhd, Gd, Gd, Gd, Re, Gd, Gd, Gd, Gd, Gd, Gd, Gd, Gll, Ce, Gll, Gd, Gd, Gd, Gd, Gd, Gd, Gd, Gd, Gd, Gd, Gd, Gd
Md, Hhd, Hhd, Hhd, Hhd, Hhd^Fdf, Hhd^Fdf, Gd, Gd, Gd, Gd^Es, Gd, Gd, Gd, Gd, Gd, Gd, Gd, Gd, Gd, Gd^Es, Gd, Gd, Gd, Gd, Gd, Wo, Wo, Gd, Gd, Gd, Gd, Gd, Gd, Gd, Gll^Fdf, Gll^Fdf, Gll^Fdf, Gd, Gd, Gd, Gd^Es, Gd, Gd, Gd, Gd, Gd, Re, Gd, Gd, Ss, Sm, Sm, Ss, Ss, Ss, Ss^Em, Ss, Ss^Vhs, Sm, Ww, Ww, Gd, Gd, Gd, Gd, Gd, Gd, Gd, Gd, Gd, Gd, Gd, Gd, Gd, Gd^Es, Gd, Gd, Gd, Gd, Hhd, Hhd, Md, Md, Md, Md^Xm, Md^Xm, Md^Xm, Md, Hhd, Hhd, Hhd, Gd, Gd, Gd, Re, Re, Gd, Gs^Vc, Gd, Gd, Gd, Ce, Ce, Re, Ce, Ce, Gd, Gd, Gs^Vc, Gd, Gd, Gd, Gd, Gd, Gd, Gd, Gd
Md, Md, Md, Hhd, Md, Hhd, Hhd, Gll^Fdf, Hhd^Fdf, Gd, Gd, Gd, Gd, Gd, Gd, Gd, Gd, Gd, Gd, Gd, Gd, Gd, Gd, Gd, Gd, Gd, Wo, Wo, Gd, Gd, Gd, Gd, Gd, Gd, Gll^Fdf, Gll^Fdf, Gll^Fdf, Gll^Fdf, Gll^Fdf, Gd, Gd, Gd, Gd, Gd, Gd, Gd, Gd, Gd, Gd, Ss, Gd, Ss^Em, Sm, Sm, Sm, Ss^Em, Ss^Em, Ss, Sm, Ss^Em, Ww, Ww, Gd, Gd, Gd, Gd, Gd, Gd, Gd, Gd, Gd, Gd, Gd, Gd, Gd, Gd, Gd, Gd, Gd, Hhd, Hhd, Hhd, Md, Md, Md, Md^Xm, Md^Xm, Md^Xm, Md^Xm, Md, Md, Hhd, Hhd, Gd, Gd, Gd, Re, Gd, Gd, Gd, Ket, Ce, Re, Re, Re, Re, Re, Ce, Gd, Gd, Gd, Gd, Gd, Gd, Gd, Gd, Gd, Gd
Md, Md, Md, Md, Md, Md, Hhd, Hhd^Fdf, Hhd^Fdf, Gd, Gd, Gd, Gd, Gd, Gll, Gd, Gll, Gd, Gd, Gd, Gd, Gd, Gd, Gd, Gd, Gd, Wo, Wo, Gd, Gd, Gd, Gd, Gd, Gll^Fdf, Gll^Fdf, Gll^Fdf, Gll^Fdf, Gll^Fdf, Gll^Fdf, Gll^Fdf, Gll^Fdf, Gd, Gd, Gd, Gd, Gd, Gd, Gd, Gd, Gd, Gd, Ss, Sm, Sm, Sm^Bw\r, Sm, Ss, Ss, Ww, Ww, Ww, Ww, Gd, Gd, Gd, Gd, Gd, Gd, Gd, Gd, Gd, Gd, Gd, Gd, Gd, Gd, Gd, Gd, Hhd, Hhd, Hhd, Md, Md, Md, Md, Md, Md^Xm, Md^Xm, Md^Xm, Md^Xm, Md, Hhd, Hhd, Gd, Gd, Gd, Gd, Re, Re, Gd, Re, Re, Re, Re, Ch, Re, Re, Ket, Re, Gd, Re, Re, Re, Gd, Gd, Gd, Re, Gd
Md, Md, Md, Md, Md, Md, Md, Hhd, Hhd, Hhd, Hhd, Gd, Gll^Fdf, Gll^Fdf, Gll^Fdf, Gll^Fdf, Gll^Fdf, Gd, Gll, Gd, Gd, Gd, Gd^Es, Gd, Gd, Gd, Wo, Wo, Gd, Gd, Gd, Gd, Gd, Gd, Gd, Gll^Fdf, Gll^Fdf, Gll^Fdf, Gll^Fdf, Gll^Fdf, Gll^Fdf, Gd, Gd, Gd, Gd, Gd, Gd, Gd, Gd, Gd, Gd, Ss, Ss, Sm, Sm, Sm, Ww^Bw\r, Ww, Ww, Ww, Gd, Gd, Gd, Gd, Gd, Gd, Gd, Gd, Gd, Gd, Gd, Gd, Gd, Gd, Gd, Gd, Gd, Gd, Hhd, Hhd, Hhd, Md, Md, Md, Md^Xm, Md^Xm, Md^Xm, Md^Xm, Md, Md^Xm, Md, Hhd, Hhd, Gd, Gd, Gd, Gd, Gd, Gd, Re, Re, Re, Re, Ch, Kh, Ch, Re, Re, Re, Re, Re, Re, Re, Re, Re, Re, Re, Re
Md, Md, Md, Md, Md, Md, Md, Hhd, Hhd, Hhd, Hhd, Gll^Fdf, Gll^Fdf, Gll^Fdf, Hhd^Fdf, Gll^Fdf, Hhd^Fdf, Gll^Fdf, Gll^Fdf, Gd, Gd, Gd, Gd, Gd, Gd, Gd, Wo, Wo, Gd, Gd, Gd, Gd, Gd, Gd, Gd, Gll^Fdf, Gll^Fdf, Gll^Fdf, Gll^Fdf, Gll^Fdf, Gd, Gd, Gd, Gd, Gd, Gd, Gd, Gd, Gd, Gd, Gd, Gd, Gd, Ss, Ss, Sm, Ww, Ww^Bw\r, Gd, Gd, Gd, Gd, Gd, Gd, Gd, Gd, Gd, Gd, Gd, Gd, Gd, Gd, Gd, Gd, Gd, Gd, Gd, Hhd, Hhd, Hhd, Md, Md, Md, Md^Xm, Md, Md^Xm, Md^Xm, Md^Xm, Md, Md, Md, Hhd, Hhd, Hhd, Gd, Gd, Gd, Gd, Gd, Gd, Ket, Re, Re, Ch, Ch, Ch, Re, Re, Re, Re, Gd, Gs^Vc, Gd, Re, Re, Re, Gd, Gd
Md, Md, Md, Md, Md, Md, Md, Md, Md, Hhd, Hhd, Hhd, Hhd, Hhd^Fdf, Hhd^Fdf, Hhd^Fdf, Hhd^Fdf, Hhd^Fdf, Gll^Fdf, Gd, Gd, Gd, Gd, Gd, Gd, Gd, Wo, Wo, Gd, Gd, Gd, Gd, Gd, Gd, Gd, Gd, Gd, Gll^Fdf, Gd, Gll^Fdf, Gd, Gd, Gd, Gd, Gd, Gd, Gd, Gd, Gd, Gd, Gd, Gd, Gd, Gd, Gd, Ss, Ww, Gd, Gd, Gd, Gd, Gd, Gd, Gd, Gd, Gd, Gd, Gd, Gd, Gd, Gd, Gd, Gd, Gd, Gd, Gd, Hhd, Hhd, Hhd, Hhd, Md, Md, Md, Md^Xm, Md, Md^Xm, Md^Xm, Md^Xm, Md^Xm, Md, Md, Md, Hhd, Hhd, Hhd, Gd, Gd, Gd, Gd, Gd, Ce, Re, Re, Re, Re, Re, Re, Ket, Gd, Gd, Gd, Gd, Gd, Gd, Gd, Gd, Gd, Gd
Md, Md, Md, Md, Md, Md, Md, Md, Md, Md, Md, Md, Md, Hhd, Hhd, Hhd^Fdf, Hhd^Fdf, Hhd^Fdf, Gll^Fdf, Gll^Fdf, Gll, Gd, Gd, Gd, Gd, Gd, Wo, Wo, Gd, Gd, Gd, Gd, Gd, Gd, Gd, Gd, Gd, Gd, Gd, Gd, Gd, Gd, Gd, Gd, Gd, Gd, Gd, Gd, Gd, Gd, Gd, Gd, Gd, Gd, Ww, Ww, Ww, Gd, Gd, Gd, Gd, Gd, Gd, Gd, Gd, Gd, Gd, Gd, Gd, Gd, Gd, Gd, Gd, Gd, Gd, Gd, Hhd, Hhd, Hhd, Md, Md, Md, Md^Xm, Md, Md, Md^Xm, Md^Xm, Md^Xm, Md^Xm, Md, Md, Md, Md, Hhd, Hhd, Gd, Gd, Gd, Gd, Gs^Vc, Gd, Ce, Ce, Re, Re, Re, Ce, Ce, Gd, Gd, Gd, Gd, Gd, Gd, Gd, Gd, Gd, Gd
Md, Md, Md, Md, Md, Md, Md, Md, Md, Md, Md, Md, Md, Md, Hhd, Hhd^Fdf, Hhd^Fdf, Hhd^Fdf, Gll^Fdf, Gll^Fdf, Gd, Gd, Gd, Gd, Gd, Gd, Wo, Wo, Gd, Gd, Gd, Gd, Gd, Gd, Gd, Gd, Gd, Gd, Gd, Gd, Gd, Gd, Gd, Gd, Gd, Gd, Gd, Gd, Gd, Gd, Gd, Gd, Gd, Ww, Wo, Wo, Wo, Ww, Gd, Gd, Gd, Gd, Gd, Gd, Gd, Gd, Gd, Gd, Gd, Gd, Gd, Gd, Gd, Gd, Gd, Gd, Hhd, Hhd, Md, Md, Md, Md^Xm, Md, Md, Md^Xm, Md^Xm, Md^Xm, Md^Xm, Md^Xm, Md, Md, Md, Md, Hhd, Hhd, Gd, Gd, Gd, Gd, Gd, Gd, Gd, Gd, Ce, Ce, Ce, Gd, Gd, Gd, Gd, Gs^Vc, Gd, Gd, Gd, Gd, Gd, Gd, Gd
Md, Md, Md, Md, Md, Md, Md, Md, Md, Md, Md, Md, Md, Md, Hhd, Hhd^Fdf, Hhd^Fdf, Hhd^Fdf, Gll^Fdf, Gll^Fdf, Gd, Gd, Gd, Gd, Gd, Gd, Wo, Wo, Gd, Gd, Gd, Gd, Gd, Gd, Gd, Gd, Gd, Gd, Gd, Gd, Gd, Gd, Gd, Gd, Gd, Gd, Gd, Gd, Gd, Gd, Gd, Gd, Gd, Ww, Wo, Wo, Wo, Ww, Gd, Gd, Gd, Gd, Gd, Gd, Gd, Gd, Gd, Gd, Gd, Gd, Gd, Gd, Gd, Gd, Gd, Hhd, Gd, Hhd, Md, Md, Md^Xm, Md^Xm, Md, Md, Md^Xm, Md^Xm, Md^Xm, Md^Xm, Md^Xm, Md, Md, Md, Md, Md, Hhd, Gd, Gd, Gd, Gd, Gd, Gd, Gd, Gd, Gd, Gd, Gd, Gd, Gd, Gd, Gd, Gd, Gd, Gd, Gd, Gd, Gd, Gd, Gd
