border_size=1
usage=map

Xu, Xu, Xu, Xu, Xu, Xu, Xu, Xu, Xu, Xu, Xu, Xu, Xu, Xu, Wwg, Wwg, Wwg, Xu, Xu, Xu, Xu, Xu, Xu, Xu, Xu, Xu, Xu, Xu, Xu, Xu, Xu, Xu
Xu, Xu, Xu, Xu, Xu, Xu, Xu, Xu, Xu, Xu, Xu, Xu, Xu, Wwg, Wwg, Wwg, Wwg, Xu, Xu, Xu, Xu, Xu, Xu, Xu, Xu, Xu, Xu, Xu, Xu, Xu, Xu, Xu
Xu, Xu, Xu, Xu, Xu, Xu, Xu, Xu, Xu, Xu, Xu, Xu, Wwg, Wwg, Wwg, 1 Wwg, Xu, Wwg, Ww^Vm, Xu, Xu, Xu, Xu, Xu, Xu, Xu, Wwg, Xu, Xu, Xu, Xu, Xu
Xu, Xu, Xu, Xu, Xu, Xu, Xu, Xu, Xu, Xu, Wwg, Wwg, Xu, Wwg, Wwg, Wwg, Wwg, Wwg, Wwg, Xu, Xu, Xu, Xu, Xu, Wwg, Wwg, Xu, Wwg, Wwg, Xu, Xu, Xu
Xu, Xu, Xu, Xu, Xu, Xu, Xu, Xu, Wwg, Wwg, Xu, Wwg, Wwg, Wwg, Wwg, Wwg, Wwg, Wwg, Wwg, Wwg, Wwg, Xu, Wwg, Wwg, Wwg, Xu, Wwg, Xu, Xu, Wwg, Xu, Xu
Xu, Xu, Xu, Xu, Xu, Xu, Xu, Wwg, Xu, Xu, Wwg, Wwg, Wwg, Wwg, Wwg, Wwg, Xu, Wwg, Wwg, Xu, Wwg, Wwg, Xu, Xu, Wwg, Wwg, Xu, Wwg, Wwg, Wwg, Xu, Xu
Xu, Xu, Xu, Xu, Xu, Xu, Wwg, Wwg, Xu, Wwg, Wwg, Wwg, Xu, Wwg, Wwg, Xu, Xu, Xu, Xu, Wwg, Ww^Vm, Wwg, Wwg, Wwg, Xu, Xu, Xu, Wwg, Wwg, Wwg, Wwg, Xu
Xu, Xu, Xu, Xu, Xu, Xu, Wwg, Wwg, Wwg, Wwg, Xu, Xu, Xu, Xu, Xu, Xu, Xu, Xu, Xu, Xu, Xu, Xu, Xu, Xu, Xu, Xu, Xu, Ww^Vm, Wwg, Xu, Wwg, Xu
Xu, Xu, Xu, Xu, Wwg, Wwg, Xu, Wwg, Wwg, Ww^Vm, Xu, Xu, Xu, Xu, Wwg, Xu, Wwg, Xu, Xu, Xu, Xu, Xu, Wwg, Xu, Xu, Xu, Xu, Xu, Wwg, Xu, Wwg, Xu
Xu, Xu, Xu, Wwg, Wwg, Xu, Wwg, Wwg, Xu, Xu, Wwg, Wwg, Wwg, Xu, Wwg, Wwg, Wwg, Xu, Xu, Xu, Xu, Wwg, Xu, Wwg, Xu, Xu, Xu, Wwg, Wwg, Xu, Wwg, Xu
Xu, Xu, Xu, Wwg, Wwg, Wwg, Xu, Xu, Xu, Xu, Wwg, Ww^Vm, Wwg, Wwg, Wwg, Xu, Wwg, Xu, Xu, Xu, Xu, Wwg, Xu, Wwg, Wwg, Wwg, Wwg, Wwg, Wwg, Wwg, Xu, Xu
Xu, Xu, Xu, Wwg, Wwg, Wwg, Wwg, Xu, Xu, Wwg, Wwg, Wwg, Xu, Xu, Xu, Wwg, Wwg, Xu, Xu, Xu, Xu, Wwg, Wwg, Xu, Wwg, Wwg, Wwg, Wwg, Xu, Xu, Xu, Xu
Xu, Xu, Xu, Ww^Vm, Wwg, Xu, Xu, Wwg, Wwg, Wwg, Xu, Xu, Xu, Xu, Xu, Wwg, Xu, Wwg, Xu, Xu, Xu, Xu, Xu, Wwg, Ww^Vm, Wwg, Wwg, Wwg, Wwg, Xu, Xu, Xu
Xu, Xu, Xu, Xu, Wwg, Wwg, Xu, Wwg, Wwg, Wwg, Wwg, Xu, Xu, Xu, Xu, Wwg, Wwg, Wwg, Wwg, Xu, Xu, Xu, Xu, Xu, Xu, Xu, Wwg, Wwg, Wwg, Xu, Xu, Xu
Xu, Xu, Xu, Wwg, Wwg, Wwg, Wwg, Wwg, Wwg, Xu, Wwg, Xu, Xu, Xu, Xu, Xu, Xu, Wwg, Xu, Wwg, Xu, Xu, Wwg, Xu, Wwg, Wwg, Xu, Wwg, Xu, Xu, Xu, Xu
Xu, Xu, Xu, Wwg, Wwg, Wwg, Xu, Xu, Wwg, Wwg, Wwg, Xu, Wwg, Xu, Xu, Xu, Xu, Wwg, Wwg, Wwg, Ww^Vm, Wwg, Xu, Wwg, Xu, Xu, Wwg, Wwg, Wwg, Xu, Xu, Xu
Xu, Xu, Xu, Wwg, Wwg, Ww^Vm, Xu, Xu, Xu, Wwg, Xu, Wwg, Xu, Wwg, Xu, Xu, Xu, Xu, Xu, Xu, Wwg, Xu, Xu, Xu, Xu, Xu, Wwg, Xu, Wwg, Xu, Xu, Xu
Xu, Xu, Xu, Xu, Wwg, Xu, Xu, Wwg, Wwg, Xu, Xu, Wwg, Wwg, Wwg, Xu, Xu, Xu, Xu, Xu, Wwg, Wwg, Xu, Xu, Xu, Xu, Xu, Wwg, Wwg, Xu, Xu, Xu, Xu
Xu, Xu, Xu, Wwg, Wwg, Wwg, Wwg, Xu, Xu, Wwg, Wwg, Xu, Wwg, Wwg, Wwg, Xu, Xu, Xu, Wwg, Wwg, Xu, Xu, Xu, Xu, Xu, Wwg, Wwg, Wwg, Xu, Xu, Xu, Xu
Xu, Xu, Wwg, Wwg, Wwg, Wwg, Wwg, Wwg, Xu, Xu, Wwg, Xu, Wwg, Xu, Wwg, Xu, Xu, Wwg, Xu, Xu, Xu, Xu, Wwg, Wwg, Wwg, Wwg, Ww^Vm, Wwg, Wwg, Wwg, Wwg, Xu
Xu, Xu, Wwg, Wwg, Wwg, Wwg, Wwg, Wwg, Xu, Xu, Wwg, Xu, Xu, Wwg, Xu, Wwg, Wwg, Wwg, Xu, Xu, Xu, Wwg, Wwg, Wwg, Wwg, Xu, Xu, Xu, Wwg, Xu, Wwg, Xu
Xu, Xu, Wwg, Wwg, Wwg, Wwg, Wwg, Wwg, Xu, Xu, Wwg, Xu, Xu, Xu, Xu, Xu, Wwg, Xu, Xu, Xu, Wwg, Wwg, Wwg, Wwg, Xu, Xu, Xu, Xu, Xu, Wwg, Xu, Xu
Xu, Xu, Wwg, Wwg, Ww^Vm, Wwg, Wwg, Wwg, Wwg, Xu, Wwg, Xu, Xu, Xu, Xu, Wwg, Wwg, Xu, Wwg, Wwg, Xu, Xu, Xu, Xu, Xu, Xu, Xu, Xu, Wwg, Wwg, Wwg, Xu
Xu, Xu, Wwg, Xu, Xu, Xu, Xu, Wwg, Xu, Wwg, Xu, Wwg, Wwg, Wwg, Wwg, Wwg, Xu, Wwg, Xu, Xu, Xu, Xu, Xu, Wwg, Wwg, Xu, Ww^Vm, Xu, Wwg, Xu, Wwg, Xu
Xu, Xu, Wwg, Wwg, Wwg, Xu, Xu, Xu, Xu, Xu, Xu, Xu, Wwg, Wwg, Xu, Xu, Xu, Xu, Xu, Xu, Xu, Xu, Xu, Xu, Wwg, Xu, Wwg, Xu, Wwg, Wwg, Xu, Xu
Xu, Xu, Wwg, Xu, Xu, Wwg, Xu, Xu, Xu, Xu, Xu, Xu, Wwg, Wwg, Wwg, Xu, Xu, Xu, Xu, Xu, Xu, Xu, Xu, Xu, Wwg, Wwg, Wwg, Wwg, Wwg, Xu, Xu, Xu
Xu, Xu, Xu, Wwg, Wwg, Wwg, Wwg, Xu, Xu, Xu, Xu, Xu, Wwg, Xu, Wwg, Xu, Xu, Xu, Xu, Ww^Vm, Wwg, Xu, Xu, Xu, Wwg, Wwg, Xu, Wwg, Xu, Xu, Xu, Xu
Xu, Xu, Xu, Xu, Xu, Wwg, Wwg, Xu, Xu, Xu, Xu, Xu, Xu, Wwg, Wwg, Xu, Xu, Xu, Wwg, Wwg, Xu, Wwg, Wwg, Wwg, Wwg, Wwg, Xu, Wwg, Xu, Xu, Xu, Xu
Xu, Xu, Xu, Xu, Xu, Wwg, Wwg, Wwg, Wwg, Xu, Xu, Xu, Xu, Wwg, Wwg, Xu, Xu, Xu, Wwg, Wwg, Xu, Xu, Wwg, Xu, Xu, Xu, Xu, Wwg, Xu, Xu, Xu, Xu
Xu, Xu, Xu, Xu, Wwg, Xu, Wwg, Xu, Xu, Wwg, Ww^Vm, Xu, Xu, Wwg, Xu, Xu, Xu, Xu, Wwg, Wwg, Xu, Xu, Wwg, Xu, Xu, Xu, Xu, Wwg, Xu, Xu, Xu, Xu
Xu, Xu, Xu, Xu, Wwg, Wwg, Ww^Vm, Wwg, Wwg, Wwg, Wwg, Xu, Wwg, Wwg, Xu, Xu, Xu, Xu, Wwg, Xu, Xu, Wwg, Xu, Xu, Xu, Xu, Wwg, Wwg, Xu, Xu, Xu, Xu
Xu, Xu, Xu, Xu, Wwg, Xu, Xu, Xu, Xu, Wwg, Wwg, Wwg, Xu, Wwg, Xu, Xu, Xu, Xu, Wwg, Wwg, Wwg, Wwg, Xu, Xu, Wwg, Wwg, Wwg, Wwg, Xu, Xu, Xu, Xu
Xu, Xu, Xu, Xu, Wwg, Xu, Xu, Xu, Xu, Xu, Xu, Xu, Wwg, Wwg, Xu, Xu, Xu, Xu, Wwg, Wwg, Xu, Xu, Xu, Xu, Wwg, Wwg, Wwg, Wwg, Wwg, Xu, Xu, Xu
Xu, Xu, Xu, Wwg, Wwg, Xu, Wwg, Xu, Xu, Xu, Xu, Xu, Xu, Wwg, Wwg, Wwg, Wwg, Wwg, Wwg, Xu, Xu, Xu, Xu, Xu, Xu, Xu, Xu, Xu, Wwg, Xu, Xu, Xu
Xu, Xu, Xu, Xu, Wwg, Wwg, Xu, Wwg, Xu, Xu, Xu, Xu, Xu, Xu, Wwg, Wwg, Wwg, Wwg, Xu, Xu, Xu, Xu, Xu, Xu, Xu, Xu, Xu, Xu, Wwg, Xu, Xu, Xu
Xu, Xu, Xu, Xu, Xu, Xu, Wwg, Wwg, Xu, Xu, Xu, Xu, Xu, Xu, Xu, Wwg, Xu, Xu, Xu, Xu, Xu, Xu, Wwg, Wwg, Wwg, Xu, Xu, Xu, Wwg, Wwg, Xu, Xu
Xu, Xu, Xu, Xu, Wwg, Xu, Wwg, Xu, Xu, Xu, Xu, Xu, Xu, Xu, Xu, Xu, Xu, Xu, Xu, Xu, Xu, Xu, Wwg, Wwg, Wwg, Wwg, Wwg, Xu, Wwg, Wwg, Xu, Xu
Xu, Xu, Xu, Xu, Wwg, Wwg, Wwg, Xu, Xu, Xu, Xu, Xu, Xu, Xu, Wwg, Wwg, Wwg, Xu, Xu, Xu, Xu, Xu, Wwg, Wwg, Ww^Vm, Wwg, Wwg, Wwg, Wwg, Xu, Xu, Xu
Xu, Xu, Xu, Wwg, Wwg, Wwg, Wwg, Wwg, Ww^Vm, Xu, Xu, Xu, Xu, Wwg, Wwg, Wwg, Wwg, Wwg, Xu, Xu, Xu, Xu, Wwg, Wwg, Wwg, Wwg, Wwg, Wwg, Xu, Xu, Xu, Xu
Xu, Xu, Xu, Wwg, Wwg, Wwg, Wwg, Wwg, Xu, Xu, Xu, Xu, Xu, Wwg, Wwg, Wwg^Ii, Wwg, Wwg, Xu, Xu, Xu, Xu, Xu, Wwg, Wwg, Wwg, Wwg, Xu, Xu, Xu, Xu, Xu
Xu, Xu, Xu, Xu, Xu, Wwg, Wwg, Wwg, Xu, Xu, Xu, Xu, Xu, Wwg, Wwg, Wwg, Wwg, Wwg, Xu, Xu, Xu, Xu, Xu, Xu, Xu, Wwg, Xu, Xu, Xu, Xu, Xu, Xu
Xu, Xu, Xu, Xu, Xu, Xu, Xu, Xu, Xu, Xu, Xu, Xu, Xu, Xu, Xu, Wwg, Xu, Xu, Xu, Xu, Xu, Xu, Xu, Xu, Xu, Xu, Xu, Xu, Xu, Xu, Xu, Xu
Xu, Xu, Xu, Xu, Xu, Xu, Xu, Xu, Xu, Xu, Xu, Xu, Xu, Xu, Xu, Xu, Xu, Xu, Xu, Xu, Xu, Xu, Xu, Xu, Xu, Xu, Xu, Xu, Xu, Xu, Xu, Xu