Wot, Wot, Wot, Wot, Wot, Wot, Wot, Wot, Wwt, Ds, Gs^Ft, Gs^Ft, Gs^Ft, Hh^Ft, Hh^Ft, Hh^Ft, Hh^Ft, Hh^Ft, Gs^Ft, Gs, Gs, Gs, Gs, Gs, Gs, Gs, Gs, Gs, Gs, Gs, Gs, Gs^Efm, Gs, Gs^Efm, Gs^Efm, Co, Ko, Co, Gs, Gs^Efm, Gs^Efm, Gs^Efm, Gs^Efm, Gs^Efm, Gs, Gs, Gs, Gs, Gs, Gs, Gs, Gs, Gs, Gs, Gs, Gs, Gs, Gs, Gs, Gs, Gs, Gs, Gs, Gs, Gs, Gs, Gs
Wot, Wot, Wot, Wot, Wot, Wot, Wot, Wot, Wwt, Ds, Ds, Gs^Ft, Gs^Ft, Gs^Ft, Gs^Ft, Hh^Ft, Gs^Ft, Gs^Ft, Gs^Ft, Gs^Ft, Gs^Ft, Gs, Gs, Gs, Gs, Gs, Gs^Efm, Gs^Efm, Gs^Efm, Gs, Gs, Gs^Efm, Gs^Efm, Gs^Efm, Gs^Efm, Co, Co, Co, Gs^Efm, Gs, Gs^Efm, Gs^Efm, Gs^Es, Gs, Gs, Gs, Gs, Gs, Gs, Gs, Gs, Gs, Gs, Gs, Gs, Gs, Gs, Gs, Gs, Gs, Gs, Gs, Gs, Gs, Gs, Gs, Gs
Wot, Wot, Wot, Wot, Wot, Wot, Wot, Wot, Wot, Wwt, Wwt, Ds, Gs^Ft, Gs^Ft, Gs^Ft, Gs^Ft, Gs^Ft, Gs^Ft, Gs^Ft, Gs^Ft, Gs, Gs, Gs, Gs, Gs, Gs, Gs^Efm, Gs, Gs, Gs^Es, Gs^Efm, Gs, Gs, Gs^Efm, Gs, Gs, Gs, Gs, Gs^Efm, Gs, Gs^Efm, Gs^Efm, Gs, Gs, Gs, Gs, Hh, Hh, Hh, Gs, Gs, Gs, Gs, Gs, Gs, Gs, Gs, Gs, Gs, Gs, Gs, Gs, Gs, Gs, Gs, Gs, Gs
Wot, Wot, Wot, Wot, Wot, Wot, Wot, Wot, Wot, Wwt, Wwt, Wwt, Wwt, Gs^Ft, Gs^Ft, Gs^Ft, Gs^Ft, Gs^Ft, Gs^Ft, Gs^Ft, Gs, Gs, Gs, Gs, Gs, Gs, Gs, Gs^Efm, Gs, Gs, Gs^Efm, Gs, Gs, Gs, Gs, Gs, Gs, Gs, Gs, Gs^Efm, Gs, Gs, Gs, Gs, Hh, Hh, Hh, Hh, Hh, Hh, Gs, Gs, Gs, Gs, Gs, Gs, Gs, Gs, Gs, Gs, Gs, Gs, Gs, Gs, Gs, Gs, Gs
Wot, Wot, Wot, Wot, Wot, Wot, Wot, Wot, Wot, Wwt, Wwt, Wwt, Wwt, Wwt, Wwt, Wwt, Wwt, Gs^Ft, Wwt, Gs, Gs, Gs, Gs, Gs, Gs, Gs, Gs, Gs, Gs, Gs^Efm, Gs^Efm, Gs^Efm, Gs, Gs, Gs, Gs, Hh, Gs, Gs, Gs, Gs, Gs, Gs, Gs, Hh, Hh, Hh, Hh, Hh, Hh, Gs, Gs, Gs, Gs, Gs, Gs, Gs, Gs, Gs, Gs, Gs, Gs, Gs, Gs, Gs, Gs, Gs
Wot, Wot, Wot, Wot, Wot, Wot, Wot, Wot, Wwt, Wwt, Ds, Wwt, Wwt, Wwt, Wwt, Wwt, Wwt, Wwf, Wwt, Wwt, Wwt, Gs, Wwt, Gs, Gs, Gs, Gs, Gs, Gs, Gs, Gs, Gs, Gs, Gs, Hh, Hh, Hh, Hh, Gs, Gs, Gs, Gs, Hh, Hh, Hh, Hh, Hh, Hh, Hh, Hh, Gs, Gs, Gs, Gs, Gs, Gs, Gs, Gs, Gs, Gs, Gs, Gs, Gs, Gs, Gs, Gs, Gs
Wot, Wot, Wot, Wot, Wot, Wot, Wot, Wot, Wwt, Ds, Hh, Hh^Ft, Hh^Ft, Hh^Ft, Hh^Ft, Hh^Ft, Hh^Ft, Hh^Ft, Hh^Ft, Wwt, Wwt, Wwt, Wwt, Wwt, Gs, Gs, Gs, Gs, Gs, Gs, Gs, Gs, Gs, Hh, Hh, Hh, Hh, Hh, Hh, Gs, Gs, Hh, Hh, Hh, Hh, Hh, Hh, Hh, Hh, Hh, Gs, Gs, Gs, Gs, Gs, Gs, Gs, Gs, Gs, Gs, Gs, Gs, Gs, Gs, Gs, Gs, Gs
Wot, Wot, Wot, Wot, Wot, Wot, Wwt, Wwt, Ds, Ds, Hh, Hh^Ft, Hh^Ft, Hh^Ft, Hh^Ft, Hh^Ft, Hh^Ft, Hh^Ft, Hh^Ft, Wwt, Hh^Ft, Wwt, Wwt, Wwt, Wwt, Gs, Gs, Gs, Wwt, Ss, Ss, Ss, Ss, Hh, Hh, Hh, Hh, Hh, Hh, Gs, Gs, Hh, Hh, Hh, Hh, Hh, Hh, Hh, Gs, Gs, Gs, Gs, Gs, Gs, Gs, Gs, Gs, Gs, Gs, Gs, Gs, Gs, Gs^Ft, Gs, Gs^Ft, Gs, Gs^Ft
Wot, Wot, Wot, Wot, Wot, Wot, Wwt, Ds, Hh, Hh, Hh, Hh, Hh, Hh^Ft, Hh, Hh, Hh, Hh^Ft, Hh^Ft, Hh^Ft, Hh^Ft, Hh^Ft, Wwt, Wwt, Wwt, Wwt, Wwf, Wwt, Wwt, Wwt, Wwt, Ss, Ss, Ss, Ss, Hh, Hh, Hh, Hh, Gs, Gs, Gs, Gs, Hh, Gs, Hh, Gs, Gs, Gs, Gs, Gs, Gs, Gs, Gs, Gs, Gs, Gs, Gs, Gs, Gs, Gs, Gs^Ft, Hh^Ft, Gs^Ft, Gs^Ft, Gs^Ft, Gs^Ft
Wot, Wot, Wot, Wot, Wot, Wot, Wwt, Ds, Hh, Hh, Gs, Gs, Gs, Hh, Gs, Gs, Hh, Hh^Ft, Hh^Ft, Hh^Ft, Hh^Ft, Hh^Ft, Hh^Ft, Hh, Hh, Wwt, Wwf, Wwt, Hh^Ft, Wwt, Wwt, Ds, Ss, Ss, Ss, Ss, Ss, Hh, Gs, Gs, Gs, Gs, Gs, Gs, Gs, Gs, Gs, Gs, Gs, Gs, Gs, Gs, Gs, Gs, Gs, Gs, Gs, Gs, Gs^Ft, Gs^Ft, Gs^Ft, Hh^Ft, Hh^Ft, Hh^Ft, Hh^Ft, Hh^Ft, Hh^Ft
Wot, Wot, Wot, Wot, Wot, Wot, Wwt, Ds, Hh, Hh, Gs, Gs, Gs, Gs, Gs, Gs, Gs, Hh, Hh, Hh, Hh, Hh^Ft, Hh, Hh^Ft, Hh^Ft, Hh, Hh^Ft, Hh^Ft, Hh^Ft, Wwt, Wwt, Ds, Ds, Ss, Ss, Ss, Ss, Ss, Ss, Gs, Gs, Gs, Gs, Gs, Gs, Gs, Gs, Gs, Gs, Gs, Gs, Gs, Gs, Gs, Gs, Gs, Gs, Gs, Gs^Ft, Gs^Ft, Gs^Ft, Hh^Ft, Hh^Ft, Hh^Ft, Hh^Ft, Hh^Ft, Hh^Ft
Wot, Wot, Wot, Wot, Wot, Wwt, Ds, Ds, Gs, Gs, Gs, Gs, Gs, Gs, Gs, Gs, Gs, Gs, Gs, Gs, Gs, Hh, Gs, Hh, Hh, Hh^Ft, Hh^Ft, Hh^Ft, Hh^Ft, Wwt, Wwt, Wwt, Wwt, Ss, Ss, Ss, Ss, Ds, Ds, Ss, Ss, Ss, Ss, Gs, Gs, Gs, Gs, Gs, Gs, Gs, Gs, Gs, Gs, Gs, Gs, Gs, Gs, Gs, Gs, Gs^Ft, Gs^Ft, Gs^Ft, Gs^Ft, Hh^Ft, Hh^Ft, Hh^Ft, Gs^Ft
Wot, Wot, Wot, Wot, Wot, Wwt, Ds, Gs, Gs, Gs, Gs, Gs, Gs, Gs, Gs, Gs, Gd^Vo, Gs, Gs, Gs, Gs, Gs, Gs, Gs, Gs, Hh, Hh, Hh, Hh^Ft, Hh^Ft, Wwt, Wwt, Wwt, Ds, Ds, Ds, Wwt, Wwt, Wwt, Ss, Ss, Ss, Wwt, Wwt, Wwt, Gs, Wwt, Gs, Gs, Gs, Gs, Gs, Gs, Gs, Gs, Gs, Gs, Gs, Gs, Gs, Gs^Ft, Gs^Ft, Gs^Ft, Gs^Ft, Gs^Ft, Gs^Ft, Gs^Ft
Wot, Wot, Wot, Wot, Wot, Wwt, Ds, Gs, Gs, Gs, Gs, Gs, Gs, Gs, Gs, Gs, Gs, Gs, Gs, Gs, Gs^Es, Gs, Gs, Gs, Gs, Gs, Gs, Hh, Hh^Ft, Hh, Hh, Wwt, Wwt, Wwt, Wwt, Wwt, Wwt, Wwt, Wwt, Wwt, Wwt, Wwt, Wwt, Wwt, Wwt, Wwf, Wwt, Wwt, Wwt, Gs, Gs, Gs, Gs, Gs, Gs, Gs, Gs, Gs, Wwt, Wwt, Wwt, Gs^Ft, Wwt, Gs^Ft, Wwt, Wwt, Wwt
Wot, Wot, Wot, Wot, Wot, Wwt, Wwt, Ds, Gs^Ft, Gs^Ft, Gs^Ft, Gs, Gs, Gs, Gs, Gs, Gs, Gs, Gs, Gs^Es, Gs, Gs, Gd^Vo, Gs, Gs, Gs, Gs, Hh, Hh, Hh^Ft, Hh^Ft, Hh, Wwt, Wwt, Wwt, Wwt, Hh, Hh, Hh, Wwt, Wwt, Wwt, Hh, Hh, Hh, Wwf, Hh, Wwt, Wwt, Wwt, Wwt, Gs, Gs, Gs, Gs, Gs, Wwt, Wwt, Wwt, Wwt, Wwt, Wwt, Wwt, Wwt, Wwt, Wwt, Wwt
Wot, Wot, Wot, Wot, Wwt, Wwt, Wwt, Ds, Gs^Ft, Gs^Ft, Gs^Ft, Gs^Ft, Gs^Ft, Gs, Gs, Gs, Gs, Gs, Gs, Gs, Gs, Gs^Es, Gs, Gs, Gs, Gs, Gs, Gs, Hh, Hh, Hh, Hh, Hh, Hh, Hh, Hh, Hh, Hh^Ft, Hh^Ft, Hh, Hh, Hh, Hh^Ft, Hh^Ft, Hh^Ft, Hh, Hh^Ft, Hh, Hh, Wwt, Wwt, Wwt, Wwt, Gs, Wwt, Wwt, Wwt, Wwt, Gs^Ft, Gs^Ft, Gs^Ft, Wwt, Gs^Ft, Wwt, Gs^Ft, Gs^Ft, Gs^Ft
Wot, Wot, Wot, Wwt, Wwt, Wwt, Hh^Ft, Hh^Ft, Hh^Ft, Gs^Ft, Gs^Ft, Gs^Ft, Gs^Ft, Gs, Gs, Gs, Gs, Gs, Gs, Gs, Gs, Gs, Gs, Gs, Gs, Gs, Gs, Gs, Gs, Hh, Gs, Hh, Hh, Hh^Ft, Hh^Ft, Hh^Ft, Hh^Ft, Hh^Ft, Hh^Ft, Hh^Ft, Hh^Ft, Hh^Ft, Hh^Ft, Hh^Ft, Hh^Ft, Hh^Ft, Hh^Ft, Hh^Ft, Hh^Ft, Hh, Hh^Ft, Wwt, Wwt, Wwt, Wwt, Wwt, Gs^Ft, Gs^Ft, Gs^Ft, Gs^Ft, Gs^Ft, Gs^Ft, Gs^Ft, Gs^Ft, Gs^Ft, Gs^Ft, Gs^Ft
Wot, Wot, Wwt, Wwt, Wwt, Wwt, Hh^Ft, Hh^Ft, Hh^Ft, Hh^Ft, Gs^Ft, Gs^Ft, Gs^Ft, Gs^Ft, Gs, Gs, Gs, Gs, Gs, Gs, Gs, Gs, Gs, Gs^Es, Gs, Gs, Gs, Gs, Gs, Gs, Gs, Hh, Hh, Hh, Hh, Hh^Ft, Hh, Hh, Hh, Hh^Ft, Hh, Hh^Ft, Hh^Ft, Hh^Ft, Hh^Ft, Hh^Ft, Hh^Ft, Hh, Hh, Hh^Ft, Hh^Ft, Hh^Ft, Hh^Ft, Wwt, Hh^Ft, Gs^Ft, Gs^Ft, Gs^Ft, Gs^Ft, Gs^Ft, Gs^Ft, Gs^Ft, Hh^Ft, Gs^Ft, Gs^Ft, Gs^Ft, Gs^Ft
Wot, Wot, Wwt, Wwt, Wwt, Ds, Ds, Hh^Ft, Hh^Ft, Hh^Ft, Gs^Ft, Gs^Ft, Gs^Ft, Gs^Ft, Gs^Ft, Gs, Gs, Gs, Gs, Gs^Es, Gs, Gs, Gs, Gs^Es, Gs, Gs, Gs, Gs, Gs, Gs, Gs, Gs, Gs, Gs, Gs, Hh, Gs, Gs, Hh, Hh, Hh, Hh, Hh, Hh^Ft, Hh, Hh^Ft, Hh, Hh, Gs^Ft, Hh^Ft, Hh^Ft, Hh^Ft, Hh^Ft, Hh^Ft, Hh^Ft, Gs^Ft, Gs^Ft, Gs^Ft, Hh^Ft, Hh^Ft, Hh^Ft, Hh^Ft, Hh^Ft, Hh^Ft, Gs^Ft, Gs^Ft, Gs^Ft
Wot, Wot, Wwt, Wwt, Ds, Ds, Gs^Ftp, Gs^Ftp, Hh^Ft, Hh^Ft, Hh^Ft, Gs^Ft, Gs^Ft, Gs^Ft, Gs^Ft, Gs^Ft, Gs, Gs, Gs, Gs, Gs, Gs, Gs, Gs, Gs, Gs, Gs, Gs, Gs, Gs, Gs, Gs, Gs^Ft, Gs, Gs, Gs, Re^Vct, Gs, Hh, Hh, Hh, Hh, Gs, Hh, Hh, Hh, Gs, Gs^Ft, Gs^Ft, Gs^Ft, Gs^Ft, Hh^Ft, Hh^Ft, Hh^Ft, Hh^Ft, Gs^Ft, Gs^Ft, Gs^Ft, Hh^Ft, Hh^Ft, Hh^Ft, Hh^Ft, Hh^Ft, Hh^Ft, Hh^Ft, Gs^Ft, Gs^Ft
Wot, Wot, Wwt, Wwt, Ds, Ds, Gs^Ftp, Gs^Ftp, Hh^Ft, Hh^Ft, Hh^Ft, Hh^Ft, Hh^Ft, Gs^Ft, Gs^Ft, Gs^Ft, Gs, Gs, Gs, Gs, Gs, Gs, Gs, Gs, Gs, Gs, Gs, Gs, Gs^Ft, Gs^Ft, Gs^Ft, Gs^Ft, Hh^Ft, Gs^Ft, Gs^Ft, Gs, Gs, Gs, Gs, Hh, Gs, Gs, Gs, Gs, Gs, Gs, Gs^Ft, Gs, Gs, Gs^Ft, Gs^Ft, Gs^Ft, Gs^Ft, Hh^Ft, Gs^Ft, Gs^Ft, Gs^Ft, Gs^Ft, Gs^Ft, Hh^Ft, Hh^Ft, Hh^Ft, Hh^Ft, Hh^Ft, Hh^Ft, Hh^Ft, Gs^Ft
Wot, Wot, Wwt, Wwt, Ds, Ds, Gs^Ftp, Gs^Ftp, Gs^Ftp, Hh^Ft, Hh^Ft, Hh^Ft, Hh^Ft, Hh^Ft, Gs^Ft, Gs^Ft, Gs^Ft, Gs, Gs, Gs, Gs, Gs, Gs, Gs, Gs, Gs, Gs^Ft, Gs^Ft, Hh^Ft, Hh^Ft, Hh^Ft, Hh^Ft, Hh^Ft, Hh^Ft, Hh^Ft, Gs^Ft, Gs^Ft, Gs, Gs, Gs, Ce, Gs, Gs^Es, Re^Vct, Gs, Gs, Gs^Ft, Gs^Ft, Gs^Ft, Gs^Ft, Gs^Ft, Gs^Ft, Gs^Ft, Gs^Ft, Gs^Ft, Gs^Ft, Gs^Ft, Gs^Ft, Gs^Ft, Gs^Ft, Gs^Ft, Hh^Ft, Gs^Ft, Hh^Ft, Hh^Ft, Hh^Ft, Gs^Ft
Wot, Wot, Wot, Wwt, Wwt, Ds, Ds, Gs^Ftp, Gs^Ftp, Hh^Ft, Hh^Ft, Hh^Ft, Hh^Ft, Hh^Ft, Gs^Ft, Gs^Ft, Gs^Ft, Gs, Gs, Gs, Gs, Gs, Gd^Vo, Gs, Gs, Gs^Ft, Hh^Ft, Hh^Ft, Hh^Ft, Hh^Ft, Hh^Ft, Hh^Ft, Hh^Ft, Hh^Ft, Hh^Ft, Gs^Ft, Gs^Ft, Gs^Ft, Gs, Ce, 1 Ke, Ce, Gs^Es, Gs, Gd^Vo, Gs, Gs, Gs^Ft, Gs, Gs^Ft, Gs^Ft, Gs^Ft, Gs^Ft, Gs^Ft, Gs^Ft, Gs^Ft, Hh^Ft, Hh^Ft, Hh^Ft, Gs^Ft, Gs^Ft, Gs^Ft, Gs^Ft, Gs^Ft, Gs^Ft, Gs^Ft, Gs^Ft
Wot, Wot, Wot, Wot, Wwt, Ds, Ds, Gs^Ftp, Gs^Ftp, Hh^Ft, Hh^Ft, Hh^Ft, Hh^Ft, Gs^Ft, Gs^Ft, Gs^Ft, Gs^Ft, Gs, Gs, Gs, Gs, Gs, Gs, Gs, Gs, Gs^Ft, Hh^Ft, Hh^Ft, Gs, Gs, Gs, Hh^Ft, Gs, Gs, Gd^Vo, Gs, Co, Gs, Gs, Ce, Ce, Ce, Gs, Gs^Es, Gs, Gs, Gs, Gs^Ft, Gs, Gs^Ft, Gs^Ft, Gs^Ft, Gs^Ft, Gs^Ft, Gs^Ft, Hh^Ft, Hh^Ft, Hh^Ft, Hh^Ft, Hh^Ft, Hh^Ft, Hh^Ft, Hh^Ft, Gs^Ft, Gs^Ft, Gs^Ft, Gs^Ft
Wot, Wot, Wot, Wwt, Wwt, Ds, Ds, Gs^Ftp, Gs^Ftp, Hh^Ft, Hh^Ft, Hh^Ft, Hh^Ft, Gs^Ft, Gs^Ft, Gs^Ft, Gs, Gs, Gs, Gs, Gs, Gs, Gs, Gs, Gs, Gs^Ft, Hh^Ft, Hh^Ft, Gs, Gd^Vo, Gs, Gs, Co, Gs, Gs, Gs, Urb, Co, Co, Gs, Gs, Gs, Gs, Re^Vct, Gs, Gs, Gs^Ft, Gs^Ft, Gs^Ft, Gs^Ft, Gs^Ft, Gs^Ft, Gs^Ft, Gs^Ft, Gs^Ft, Hh^Ft, Hh^Vhh, Hh^Ft, Hh^Ft, Hh^Ft, Hh^Ft, Hh^Ft, Hh^Ft, Gs^Ft, Gs^Ft, Gs^Ft, Gs^Ft
Wot, Wot, Wot, Wwt, Wwt, Ds, Ds, Gs^Ftp, Hh^Ft, Hh^Ft, Hh^Ft, Hh^Ft, Gs^Ft, Gs^Ft, Gs^Ft, Gs^Ft, Gs, Gs, Gs, Gs, Gs^Es, Gs, Gs, Gs, Gs^Ft, Gs^Ft, Hh^Ft, Hh^Ft, Urb, Gs, Gs, Co, 2 Ko, Co, Urb, Gd^Vo, Urb, Urb, Co, Gs, Gs, Gs, Gs, Gs, Gs, Gs, Gs^Ft, Gs, Gs, Gs^Ft, Gs^Ft, Gs^Ft, Gs^Ft, Gs^Ft, Gs^Ft, Hh^Ft, Hh^Ft, Hh^Ft, Hh^Ft, Hh^Ft, Hh^Ft, Hh^Ft, Hh^Ft, Gs^Ft, Gs^Ft, Gs^Ft, Gs^Ft
Wot, Wot, Wot, Wwt, Wwt, Ds, Ds, Gs^Ftp, Hh^Ft, Hh^Ft, Hh^Ft, Hh^Ft, Gs^Ft, Gs^Ft, Gs^Ft, Gs^Ft, Gs, Gs, Gs, Gs, Gs, Gs, Gs, Gs, Gs, Gs^Ft, Gs, Co, Urb, Gd^Vo, Urb, Co, Co, Co, Gd^Vo, Urb, Gs, Urb, Co, Gs, Gs, Gs, Gs, Gs, Gs^Ft, Gs^Ft, Gs, Gs, Gs, Gs^Ft, Gs^Ft, Gs^Ft, Gs^Ft, Gs^Ft, Gs^Ft, Hh^Ft, Hh^Ft, Hh^Ft, Hh^Ft, Hh^Ft, Hh^Ft, Hh^Ft, Gs^Ft, Gs^Ft, Gs^Ft, Gs^Ft, Gs^Ft
Wot, Wot, Wot, Wot, Wwt, Wwt, Hh^Ft, Hh^Ft, Hh^Ft, Hh^Ft, Gs^Ft, Gs^Ft, Gs^Ft, Gs^Ft, Gs^Ft, Gs, Gs, Gs, Gs, Gs, Gs, Gs, Gd^Vo, Gs, Gs, Gs, Gs, Co, Urb, Urb, Gd^Vo, Gd^Vo, Urb, Gd^Vo, Gd^Vo, Urb, Co, Gs, Gs, Gs, Gs, Gd^Vo, Gs, Gs, Gs^Ft, Gs, Gs^Ft, Gs^Ft, Gs^Ft, Gs^Ft, Gs^Ft, Gs^Ft, Gs^Ft, Gs^Ft, Gs^Ft, Hh^Ft, Hh^Ft, Hh^Ft, Hh^Ft, Hh^Ft, Hh^Ft, Hh^Ft, Gs^Ft, Gs^Ft, Gs^Ft, Gs^Ft, Gs^Ft
Wot, Wot, Wot, Wwt, Wwt, Hh^Ft, Hh^Ft, Hh^Ft, Hh^Ft, Hh^Ft, Gs^Ft, Gs^Ft, Gs^Ft, Gs^Ft, Gs, Gs, Gs, Gs, Gs, Gs, Gs, Gs, Gs, Gs, Gs^Es, Gs, Gs, Co, Co, Urb, Urb, Gd^Vo, Urb, Gd^Vo, Urb, Urb, Co, Gs, Gs, Gs, Gs, Gs, Gs, Gs, Gs, Gs, Gs^Ft, Gs, Gs^Ft, Gs^Ft, Gs^Ft, Gs^Ft, Gs^Ft, Gs^Ft, Gs^Ft, Gs^Ft, Gs^Ft, Hh^Ft, Gs^Ft, Hh^Ft, Gs^Ft, Gs^Ft, Hh^Ft, Gs^Ft, Gs^Ft, Gs^Ft, Gs^Ft
Wot, Wot, Wot, Wwt, Wwt, Ds, Gs^Ft, Hh^Ft, Gs^Ft, Gs^Ft, Gs^Ft, Gs^Ft, Gs, Gs, Gs, Gs, Gs, Gs, Gs^Es, Gs, Gs, Gs, Gs, Gs, Gs, Gs, Gs, Gs, Gs, Co, Gs, Urb, Urb, Urb, Gs, Co, Gs, Gs, Gs, Gs, Gs, Gs, Gs, Gs, Gs^Ft, Gs^Ft, Gs^Ft, Gs^Ft, Gs, Gs^Ft, Gs^Ft, Gs^Ft, Gs^Ft, Gs^Ft, Gs^Ft, Gs^Ft, Gs^Ft, Gs^Ft, Gs^Ft, Gs^Ft, Hh^Ft, Hh^Ft, Hh^Ft, Hh^Ft, Hh^Ft, Gs^Ft, Gs^Ft
Wot, Wot, Wot, Wwt, Wwt, Ds, Gs^Ft, Gs^Ft, Gs^Ft, Gs^Ft, Gs^Ft, Gs^Ft, Gs, Gs, Gs, Gs, Gs, Gs, Gs^Es, Gs, Gs, Gs, Gs, Gs, Gs, Gs, Gs, Gs, Gs, Gs, Gs, Co, Co, Co, Gs, Gs, Gs, Gs, Gs, Gs, Gs, Gs, Gs, Gs, Gs^Ft, Gs^Ft, Gs^Ft, Gs^Ft, Gs^Ft, Gs^Ft, Gs^Ft, Gs^Ft, Gs^Ft, Gs^Ft, Gs^Ft, Gs^Ft, Hh^Ft, Gs^Ft, Gs^Ft, Hh^Ft, Hh^Ft, Hh^Vhh, Hh^Ft, Hh^Ft, Hh^Ft, Gs^Ft, Gs^Ft
Wot, Wot, Wot, Wwt, Wwt, Ds, Gs^Ft, Gs^Ft, Gs^Ft, Gs^Ft, Gs^Ft, Gs^Ft, Gs, Gs, Gs, Gs, Gs, Gs, Gs, Gs, Gs, Gs, Gs^Ft, Gs^Ft, Gs^Ft, Gs, Gs, Gs, Gs, Gs, Gs, Gs, Gs, Gs, Gs, Gs, Gs^Es, Gs, Gs, Gd^Vo, Gs, Gs, Gs, Gs^Ft, Gs^Ft, Gs, Gs, Gs^Ft, Gs^Ft, Gs^Ft, Gs^Ft, Gs^Ft, Gs^Ft, Gs^Ft, Gs^Ft, Hh^Ft, Hh^Ft, Hh^Ft, Hh^Ft, Hh^Ft, Hh^Ft, Hh^Ft, Hh^Ft, Hh^Ft, Hh^Ft, Gs^Ft, Gs^Ft
Wot, Wot, Wot, Wwt, Wwt, Ds, Gs^Ft, Gs^Ft, Gs^Ft, Gs^Ft, Gs^Ft, Gs, Gs, Gs, Gs, Gs, Gs, Gs, Gs, Gs, Gs^Ft, Gs^Ft, Gs^Ft, Gs^Ft, Gs^Ft, Gs^Ft, Gs^Ft, Gs, Gs, Gs, Gs^Es, Gs, Gs, Gs, Gs, Gs, Gs, Gs, Gs, Gs, Gs, Gs, Gs, Gs, Gs^Ft, Gs^Ft, Gs^Ft, Gs^Ft, Gs^Ft, Gs, Gs^Ft, Gs^Ft, Gs^Ft, Gs^Ft, Hh^Ft, Hh^Ft, Hh^Ft, Hh^Ft, Hh^Ft, Hh^Ft, Hh^Ft, Hh^Ft, Hh^Ft, Hh^Ft, Gs^Ft, Gs^Ft, Gs^Ft
Wot, Wot, Wwt, Wwt, Ds, Ds, Gs^Ft, Gs^Ft, Gs^Ft, Gs^Ft, Gs^Ft, Gs, Gs, Gs, Gs, Gs^Es, Gs, Gs, Gs, Gs, Gs^Ft, Gs^Ft, Hh^Ft, Hh^Ft, Hh^Ft, Gs^Ft, Gs^Ft, Gs, Gs, Gs, Gs, Gs, Gs, Gd^Vo, Gs, Gs, Gs, Gs, Gs, Gs, Gs, Gs, Gs, Gs, Gs, Gs^Ft, Gs, Gs^Ft, Gs, Gs^Ft, Gs^Ft, Gs^Ft, Gs^Ft, Gs^Ft, Hh^Ft, Hh^Ft, Hh^Ft, Hh^Ft, Hh^Ft, Hh^Ft, Gs^Ft, Hh^Ft, Gs^Ft, Gs^Ft, Gs^Ft, Gs^Ft, Gs^Ft
Wot, Wwt, Ds, Ds, Gs, Gs, Gs, Gs^Ft, Gs, Gs^Ft, Gs, Gs, Gs, Gs, Gs, Gs, Gs, Gs, Gs, Gs, Gs^Ft, Gs^Ft, Hh^Ft, Hh^Ft, Hh^Ft, Hh^Ft, Hh^Ft, Gs^Ft, Gs^Ft, Gs, Gs, Gs, Gs, Gs, Gs, Gs, Gs, Gs, Gs, Gs, Gs, Gs, Gs, Gs, Gs, Gs^Ft, Gs^Ft, Gs^Ft, Gs^Ft, Gs^Ft, Gs, Gs^Ft, Gs^Ft, Gs^Ft, Gs^Ft, Hh^Ft, Hh^Ft, Hh^Ft, Gs^Ft, Gs^Ft, Gs^Ft, Gs^Ft, Gs, Gs^Ft, Gs^Ft, Gs^Ft, Gs^Ft
Wwt, Wwt, Ds, Gs, Gs, Gs, Gs, Gs, Gs, Gs, Gs, Gs, Gs, Gs, Gs, Gd^Vo, Gs, Gs, Gs, Gs, Gs^Ft, Gs^Ft, Hh^Ft, Hh^Ft, Hh^Ft, Hh^Ft, Hh^Ft, Gs^Ft, Gs^Ft, Gs^Ft, Gs, Gs, Gs, Gs, Gs, Gs, Hh, Gs, Hh, Gs, Gs, Gs, Gs, Gs, Gs, Gs, Gs, Gs, Gs^Ft, Gs, Gs^Ft, Gs^Ft, Gs, Gs^Ft, Gs^Ft, Gs^Ft, Gs, Gs^Ft, Gs^Ft, Gs^Ft, Gs^Ft, Gs^Ft, Gs, Gs, Gs, Gs^Ft, Gs
Wwt, Wwt, Ds, Gs, Gs, Gs, Gs, Gs, Gs, Gs, Gs, Gs, Gs, Gs, Gs, Gs, Gs, Gs, Gs, Gs^Ft, Gs^Ft, Gs^Ft, Hh^Ft, Hh^Ft, Hh^Ft, Hh^Ft, Hh^Ft, Gs^Ft, Gs^Ft, Gs^Ft, Gs, Gs, Gs, Gs, Hh, Hh, Hh, Hh, Hh, Hh, Hh, Gs, Gs, Gs, Gd^Vo, Gs, Gs, Gs, Gs, Gs^Ft, Gs^Ft, Gs^Ft, Gs^Ft, Gs, Gs^Ft, Gs, Gs^Ft, Gs^Ft, Gs, Gs, Gs, Gs, Gs, Gs, Gs, Gs, Gs
Wwt, Ds, Ds, Gs, Gs, Gs, Gs^Ft, Gs, Gs^Ft, Gs, Gs, Gs, Gs, Gs, Gs, Gs^Es, Gs, Gs, Gs, Gs^Ft, Gs^Ft, Gs^Ft, Gs^Ft, Hh^Ft, Hh^Ft, Hh^Ft, Gs^Ft, Gs^Ft, Gs^Ft, Gs^Ft, Gs, Gs, Gs, Gs, Hh, Hh, Hh, Hh, Hh, Hh, Hh, Gs, Gs, Gs, Gs, Gs, Gs, Gs, Gs, Gs, Gs, Gs, Gs^Ft, Gs^Ft, Gs, Gs^Ft, Gs, Gs, Gs, Gs, Gs, Gs, Gs, Gs, Re^Vct, Gs, Gs
Wwt, Ds, Gs, Gs, Gs, Gs, Gs^Ft, Gs^Ft, Gs^Ft, Gs^Ft, Gs^Ft, Gs, Gs, Gs, Gs, Gs, Gs, Gs, Gs, Gs, Gs, Gs^Ft, Gs^Ft, Gs^Ft, Gs^Ft, Gs^Ft, Gs^Ft, Gs^Ft, Gs, Gs, Gs, Gs, Gs, Gs, Hh, Hh, Hh, Hh, Hh, Hh, Hh, Gs, Gs, Gs, Gs, Gs, Gs, Gs, Gs, Gs, Gs, Gs, Gs, Gs, Gs, Gs, Gs, Re^Vct, Gs, Gs, Ce, Gs, Gs, Gs, Gs, Gs, Gs
Wwt, Ds, Gs, Gs, Gs, Gs, Gs^Ft, Gs^Ft, Gs^Ft, Gs^Ft, Gs^Ft, Gs, Gs, Gs, Gs, Gs, Gs, Gs, Gs, Gs, Gs, Gs, Gs, Gs^Ft, Gs^Ft, Gs^Ft, Gs, Gs, Gs, Gs, Gs, Gs, Gs, Gs, Gs, Hh, Hh, Hh, Hh, Hh, Gs, Gs, Gs, Gs, Gs, Gs, Gs, Gs, Gs, Gs, Gs, Gs, Gs, Gs, Gs, Gs, Gs, Gs, Gs, Ce, Ce, Ce, Gs, Gs, Gs, Gs, Gs
Ds, Ds, Gs, Gs, Gs, Gs, Gs^Ft, Gs^Ft, Gs^Ft, Gs^Ft, Gs^Ft, Gs, Gs, Gs, Gs, Gs, Gs, Gs, Gs, Gs, Gs, Gs, Gs, Gs, Gs, Gs, Gs, Gs, Gs, Gs, Gs, Gs, Gs, Gs, Gs, Hh, Hh, Hh, Hh, Hh, Gs, Gs, Gd^Vo, Gs, Gs, Gs, Gs, Gs, Gs, Gs, Gs, Gs, Gs, Gs, Re^Vct, Gs, Gs, Gs, Gs, Ce, 3 Ke, Ce, Gs, Gs, Gs, Gs, Gs
Ds, Ds, Gs, Gs, Gs, Gs^Ft, Gs^Ft, Gs^Ft, Gs^Ft, Gs^Ft, Gs, Gs, Gs, Gs, Gs, Gs, Gs, Gs^Es, Gs, Gs, Gs, Gd^Vo, Gs, Gs, Gs, Gs, Gs, Gs, Gs, Gs, Gs, Gs, Gs, Gs, Gs, Gs, Gs, Gs, Gs, Gs, Gs, Gs, Gs, Gs, Gs, Gs, Gs, Gs, Gs, Gs, Gs, Gs, Gs, Gs, Gs, Gs, Gs, Gs, Gs, Ce, Ce, Ce, Gs, Gs, Re^Vct, Gs, Gs
Gs, Gs, Gs, Gs, Gs, Gs^Ft, Gs, Gs^Ft, Gs, Gs, Gs, Gs, Gs, Gs, Gs, Gs, Gs, Gs, Gs, Gs, Gs, Gs, Gs, Gs, Gs, Gs, Gs, Gs, Gs, Gs, Gs, Gs, Gs, Gs, Gs, Gs, Gs, Gs, Gs, Gs, Gs, Gs, Gs, Gs, Gs^Ft, Gs, Gs^Ft, Gs^Ft, Gs^Ft, Gs, Gs, Gs, Gs, Gs, Gs, Gs, Gs, Re^Vct, Gs, Gs, Gs, Gs, Gs, Gs, Gs, Gs, Gs
Gs, Gs, Gs, Gs, Gs, Gs, Gs, Gs, Gs, Gs, Gs, Gs, Gs, Gs, Ce, Gs, Gs, Gs, Gs, Gs, Gs, Gs, Gs, Gs, Gs, Gs, Gs, Gs, Gs, Gs, Gs, Gs, Gs, Gs, Gs, Gs, Gs, Gs, Gs, Gs, Gs, Gs, Gs^Ft, Gs^Ft, Gs^Ft, Gs^Ft, Gs^Ft, Gs^Ft, Gs^Ft, Gs^Ft, Gs^Ft, Gs^Ft, Gs^Ft, Gs^Ft, Gs^Ft, Gs, Gs, Gs, Gs, Gs, Re^Vct, Gs, Gs, Gs, Gs, Gs, Gs
Gs, Gs, Gs, Gs, Gs, Gs, Gs, Gs, Gs, Gs, Gs, Gs, Gs, Ce, Ce, Ce, Gs, Gs, Gs, Gs, Gs, Gs, Gs^Es, Gs, Gs, Gs, Gs, Gs, Gs, Gs, Gs, Gs, Gs, Gs, Gs, Gs, Gs, Gs, Gs, Gs, Gs^Ft, Gs^Ft, Gs^Ft, Gs^Ft, Gs^Ft, Gs^Ft, Gs^Ft, Gs^Ft, Gs^Ft, Gs^Ft, Gs^Ft, Gs^Ft, Gs^Ft, Gs^Ft, Gs^Ft, Gs^Ft, Gs, Gs, Gs, Gs, Gs, Gs, Gs, Gs, Hh, Hh, Hh
Gs, Gs, Gs^Es, Gs, Gs, Gs, Gs, Gs, Gs, Gs, Gs^Es, Gs, Gs^Es, Ce, 4 Ke, Ce, Gs, Gs^Es, Gs, Gs, Gs, Gs, Gs, Gs, Gs, Gs, Gs, Gs, Gs, Gs, Gs, Gs, Gs, Gs, Gs, Gs, Gs, Gs, Gs^Ft, Gs^Ft, Gs^Ft, Gs^Ft, Gs^Ft, Gs^Ft, Gs^Ft, Gs^Ft, Gs^Ft, Gs^Ft, Gs^Ft, Gs^Ft, Gs^Ft, Gs^Ft, Gs^Ft, Gs^Ft, Gs^Ft, Gs^Ft, Gs^Ft, Gs, Gs, Gs, Gs, Gs, Gs, Gs, Hh, Hh, Hh
Gs, Gs, Gs, Gs, Gs, Gs, Gs, Gs, Gs, Gs, Gs, Gs, Gs, Ce, Ce, Ce, Gs, Gs, Gs, Gs, Gs, Gs, Gs, Gs, Gs, Gs, Gs, Gs, Gs, Gs, Gs, Gs, Gs, Gs, Gs, Gs, Gs, Gs^Ft, Gs^Ft, Gs^Ft, Gs^Ft, Gs^Ft, Gs^Ft, Gs^Ft, Gs^Ft, Gs^Ft, Gs^Ft, Gs^Ft, Gs^Ft, Gs^Ft, Gs^Ft, Gs^Ft, Gs^Ft, Gs^Ft, Gs^Ft, Gs^Ft, Gs^Ft, Gs^Ft, Gs^Ft, Gs, Gs, Gs, Gs, Gs, Hh, Hh, Hh
Gs, Gs, Gs, Gs, Gs, Gs, Gs^Es, Gs, Gs, Gs, Gs, Gs, Gs^Es, Gs, Gs, Gs, Gs, Gs, Gs, Gs, Gs, Gs, Gs, Gs, Gs, Gs, Gs, Gs, Gs, Gs, Gs, Gs, Gs, Gs, Gs, Gs, Gs^Ft, Gs^Ft, Gs^Ft, Gs^Ft, Gs^Ft, Gs^Ft, Gs^Ft, Gs^Ft, Gs^Ft, Gs^Ft, Gs^Ft, Gs^Ft, Gs^Ft, Gs^Ft, Gs^Ft, Gs^Ft, Gs^Ft, Gs^Ft, Gs^Ft, Gs^Ft, Gs^Ft, Gs^Ft, Hh^Ft, Gs^Ft, Gs^Ft, Gs, Gs, Hh, Hh, Hh, Hh
Gs, Gs, Gs, Gs, Gs, Gs, Gs, Gs, Gs, Gs, Gs, Gs, Gs, Gs, Gs, Gs, Gs, Gs, Gs, Gs, Gs, Gs, Gs, Gs, Gs, Gs, Gs, Gs, Gs, Gs, Gs, Gs, Gs, Gs, Gs, Gs^Ft, Gs^Ft, Gs^Ft, Gs^Ft, Gs^Ft, Gs^Ft, Gs^Ft, Gs^Ft, Gs^Ft, Gs^Ft, Gs^Ft, Gs^Ft, Gs^Ft, Gs^Ft, Gs^Ft, Gs^Ft, Gs^Ft, Gs^Ft, Gs^Ft, Gs^Ft, Gs^Ft, Hh^Ft, Hh^Ft, Hh^Ft, Hh^Ft, Gs^Ft, Gs, Gs, Hh, Hh, Hh, Hh
Gs, Gs, Gs, Gs, Gs, Gs, Gs, Gs, Gs, Gs, Gs, Gs, Gs, Gs, Gs, Gs, Gs, Gs, Gs, Gs, Gs, Gs, Gs, Gs, Gs, Gs, Gs, Gs, Gs, Gs, Gs, Gs, Gs, Gs, Gs, Gs^Ft, Gs^Ft, Gs^Ft, Gs^Ft, Gs^Ft, Gs^Ft, Gs^Ft, Gs^Ft, Gs^Ft, Gs^Ft, Gs^Ft, Gs^Ft, Gs^Ft, Gs^Ft, Gs^Ft, Gs^Ft, Gs^Ft, Gs^Ft, Gs^Ft, Gs^Ft, Hh^Ft, Hh^Ft, Hh^Ft, Hh^Ft, Hh^Ft, Hh, Hh, Hh, Hh, Hh, Hh, Hh
Gs, Gs, Gs, Gs, Gs, Gs, Gs, Gs, Gs, Gs, Gs, Gs, Gs, Gs, Gs, Gs, Gs, Gs, Gs, Gs, Gs, Gs, Gs, Gs, Gs, Gs, Gs, Gs, Gs, Gs, Gs, Gs, Gs, Gs, Gs, Gs^Ft, Gs^Ft, Gs^Ft, Gs^Ft, Gs^Ft, Gs^Ft, Gs^Ft, Gs^Ft, Gs^Ft, Gs^Ft, Gs^Ft, Gs^Ft, Gs^Ft, Gs^Ft, Gs^Ft, Gs^Ft, Gs^Ft, Gs^Ft, Gs^Ft, Gs^Ft, Hh^Ft, Hh^Ft, Hh^Ft, Hh^Ft, Hh^Ft, Hh, Hh, Hh, Hh, Hh, Hh, Gs
