border_size=1
usage=map

Mm, Mm, Mm, Mm, Mm, Mm, Mm, Mm, Mm, Mm, Mm, Mm, Mm, Mm, Mm, Mm, Mm, Mm, Mm, Mm, Mm, Mm, Mm, Mm, Mm, Mm, Mm, Mm, Mm, Mm, Mm, Mm, Mm, Mm, Mm, Mm, Mm, Mm, Mm, Mm, Mm, Mm, Mm, Mm, Mm, Mm, Mm, Ww, Mm, Mm, Mm, Mm, Mm, Ww, Ww, Mm, Mm, Mm, Mm, Mm, Mm, Mm, Mm, Mm, Mm, Mm, Mm, Mm, Mm, Mm, Mm, Mm, Mm, Mm, Mm, Mm, Mm, Mm, Mm, Mm, Mm, Mm, Mm, Mm, Mm, Mm, Mm^Xm, Mm^Xm, Mm, Mm, Mm, Mm, Mm, Mm, Mm
Mm, Mm, Mm^Xm, Mm^Xm, Mm^Xm, Mm, Mm, Mm, Mm, Mm, Mm, Mm, Mm, Mm, Mm, Mm, Mm, Mm, Mm, Mm, Mm, Mm^Xm, Mm^Xm, Mm, Mm^Xm, Mm, Mm, Mm, Mm, Mm, Mm, Mm, Mm, Mm, Mm, Mm, Mm, Mm, Mm, Mm, Mm, Mm, Mm, Mm, Mm, Mm, Mm, Ww, Mm, Mm, Mm, Mm, Mm, Mm, Ww, Mm, Mm, Mm, Mm, Mm, Mm, Mm, Mm, Mm, Mm^Xm, Mm, Mm, Mm, Mm, Mm, Mm, Mm, Mm, Mm, Mm, Mm, Mm^Xm, Mm, Mm^Xm, Mm, Mm, Mm, Mm, Mm, Mm^Xm, Mm^Xm, Mm, Mm^Xm, Mm^Xm, Mm, Mm, Mm, Mm, Mm, Mm
Mm, Mm^Xm, Mm, Mm, Mm, Mm^Xm, Mm, Mm^Xm, Mm^Xm, Mm^Xm, Mm^Xm, Mm, Mm, Mm, Mm, Mm, Mm, Mm, Mm, Mm, Mm^Xm, Mm, Mm, Mm, Mm, Mm^Xm, Mm^Xm, Mm, Mm, Mm, Mm, Mm, Mm^Xm, Mm^Xm, Mm^Xm, Mm^Xm, Mm^Xm, Mm, Mm^Xm, Mm, Mm, Mm, Mm^Xm, Mm^Xm, Mm^Xm, Mm, Ww, Ww, Mm, Mm^Xm, Mm^Xm, Mm, Mm, Ww, Ww, Mm, Mm, Mm, Mm^Xm, Mm^Xm, Mm^Xm, Mm, Mm, Mm, Mm, Mm, Mm^Xm, Mm^Xm, Mm, Mm, Mm^Xm, Mm, Mm^Xm, Mm, Mm^Xm, Mm^Xm, Mm, Mm^Xm, Mm, Mm^Xm, Mm, Mm, Mm, Mm, Mm^Xm, Mm, Mm, Mm, Mm^Xm, Mm, Mm, Mm, Mm, Mm^Xm, Mm
Mm, Mm, Mm, Mm^Xm, Mm, Mm, Mm, Mm^Xm, Mm, Mm^Xm, Mm, Mm^Xm, Mm^Xm, Mm, Mm, Mm, Mm, Mm, Mm, Mm^Xm, Mm, Mm^Xm, Mm, Mm, Mm, Mm, Mm, Mm, Mm^Xm, Mm, Mm, Mm, Mm, Mm, Mm, Mm, Mm, Mm, Mm, Mm^Xm, Mm^Xm, Mm^Xm, Mm, Mm^Xm, Mm, Mm^Xm, Ww, Mm, Mm, Mm, Mm, Mm^Xm, Ww, Ww, Mm, Mm^Xm, Mm^Xm, Mm^Xm, Mm, Mm, Mm, Mm^Xm, Mm, Mm, Mm, Mm, Mm, Mm^Xm, Mm^Xm, Mm, Mm, Mm^Xm, Mm^Xm, Mm^Xm, Mm, Mm, Mm, Mm, Mm, Mm, Mm, Mm, Mm, Mm, Mm^Xm, Mm, Mm, Mm, Mm, Mm^Xm, Mm^Xm, Mm, Mm, Mm, Mm
Mm, Mm, Mm, Mm^Xm, Mm, Mm, Mm, Mm, Mm, Mm^Xm, Mm^Xm, Mm, Mm, Mm^Xm, Mm^Xm, Mm^Xm, Mm^Xm, Mm, Mm, Mm, Mm, Mm, Mm, Mm, Mm, Mm, Mm, Mm, Mm, Mm, Mm, Mm, Mm, Mm, Mm, Mm^Xm, Mm^Xm, Mm, Mm, Mm, Mm, Mm, Mm, Mm, Mm, Mm, Mm, Ww, Mm, Mm, Mm, Mm, Ww, Mm, Mm^Xm, Mm, Mm^Xm, Mm, Mm^Xm, Mm, Mm, Mm^Xm, Mm^Xm, Mm, Mm, Mm, Mm, Mm, Mm, Mm^Xm, Mm, Mm, Mm, Mm, Mm, Mm, Mm, Mm, Mm, Mm, Mm, Mm^Xm, Mm, Mm, Mm^Xm, Mm, Mm, Mm, Mm, Mm, Mm, Mm, Mm^Xm, Mm, Mm
Mm, Mm, Mm, Mm, Mm, Mm, Mm, Mm, Mm, Mm^Xm, Mm, Mm, Mm^Xm, Mm, Mm, Mm^Xm, Mm, Mm, Mm, Mm, Mm, Mm, Mm, Mm, Mm, Mm, Mm, Mm, Mm, Mm, Mm, Mm^Xm, Mm^Xm, Mm, Mm, Mm, Mm^Xm, Mm, Mm, Mm, Mm, Mm, Mm, Mm, Mm, Mm, Mm, Ww, Ww, Mm, Mm, Mm, Ww, Mm, Mm, Mm^Xm, Mm, Mm^Xm, Mm, Mm^Xm, Mm, Mm^Xm, Mm, Mm, Mm, Mm, Mm, Mm, Mm, Mm, Mm, Mm, Mm, Mm, Mm, Mm^Xm, Mm, Mm^Xm, Mm, Mm, Mm, Mm, Mm^Xm, Mm, Mm, Mm, Mm^Xm, Mm, Mm, Mm, Mm, Mm, Mm, Mm, Mm
Mm, Mm, Mm, Mm, Mm, Mm, Mm, Mm, Mm, Mm, Mm, Mm, Mm, Mm, Mm, Mm^Xm, Mm, Mm, Mm, Mm, Mm, Mm, Mm, Mm, Mm, Mm, Mm, Mm, Mm, Mm, Mm, Mm, Mm, Mm^Xm, Mm, Mm, Mm, Mm^Xm, Mm, Mm, Mm^Xm, Mm, Mm, Mm, Mm, Mm, Mm, Mm, Mm, Ww, Ww, Mm, Mm, Ww, Mm, Mm, Mm, Mm, Mm, Mm, Mm, Mm, Mm, Mm, Mm, Mm, Mm, Mm, Mm, Mm, Mm, Mm, Mm, Mm, Mm, Mm, Mm, Mm, Mm, Mm, Mm, Mm, Mm, Mm^Xm, Mm^Xm, Mm^Xm, Mm^Xm, Mm, Mm, Mm, Mm, Mm, Mm, Mm, Mm
Mm, Mm, Mm, Mm, Mm, Mm, Mm, Mm, Mm, Mm, Mm, Mm, Mm, Mm, Mm, Mm, Mm, Mm, Mm, Mm, Mm, Mm, Mm, Mm, Mm, Mm, Mm, Mm, Mm, Mm, Mm, Mm, Mm, Mm, Mm, Mm, Mm, Mm, Mm, Mm, Mm, Mm^Xm, Mm, Mm, Mm, Mm, Mm, Mm, Mm, Mm, Ww, Mm, Mm, Ww, Mm, Mm, Mm, Mm, Mm, Mm, Mm, Mm, Mm, Mm, Mm, Mm, Mm, Mm, Mm, Mm, Mm, Mm, Mm, Mm, Mm, Mm, Mm, Mm, Mm, Mm, Mm, Mm, Mm, Mm, Mm, Mm^Xm, Mm, Mm, Mm, Mm, Mm, Mm, Mm, Mm^Xm, Mm
Mm, Mm, Mm, Mm, Mm, Mm, Mm, Mm, Mm, Mm, Mm, Mm, Mm, Mm, Mm, Mm, Mm, Mm, Mm, Mm, Mm, Mm, Mm, Mm, Mm, Mm, Mm, Mm, Mm, Mm, Mm, Mm, Mm, Mm, Mm, Mm, Mm, Mm, Mm, Mm, Mm, Mm, Hh^Vhh, Mm, Mm^Xm, Mm, Mm, Mm, Mm, Mm, Mm, Ww, Ww, Ww, Mm, Mm, Mm, Mm, Mm, Mm, Mm, Mm, Mm, Mm, Mm, Mm, Mm, Mm, Mm, Mm, Mm, Mm, Mm, Mm, Mm, Mm, Mm, Mm, Mm, Mm, Mm, Mm, Mm, Mm, Mm, Mm, Mm, Mm, Mm^Xm, Mm, Mm, Mm, Mm, Mm, Mm
Mm, Mm, Mm, Mm, Mm, Mm, Mm, Mm, Mm, Mm, Mm, Mm, Mm, Mm, Mm, Mm, Mm, Mm, Mm, Mm, Mm, Mm, Mm, Mm, Mm, Mm, Mm, Mm, Mm, Mm, Mm, Mm, Mm, Mm, Mm, Mm, Mm, Mm, Mm, Mm, Mm, Mm, Mm, Mm, Mm, Mm, Mm, Mm, Mm, Mm^Xm, Mm, Ww, Mm, Hh^Fms, Mm, Mm, Mm, Mm, Mm, Mm, Mm, Mm, Mm, Mm, Mm, Mm, Mm, Mm, Mm, Mm, Mm, Mm, Mm, Mm, Mm, Mm, Mm, Mm, Mm, Mm, Mm, Mm, Mm, Mm, Mm, Mm, Hh^Fms, Mm, Mm, Mm, Mm, Mm, Mm, Mm, Hh^Fms
Mm, Mm, Mm, Mm, Mm, Mm, Mm, Mm, Mm, Mm, Hh^Fms, Mm, Hh^Fms, Mm, Mm, Mm, Mm, Mm, Mm, Mm, Mm, Mm, Mm, Mm, Mm, Mm, Mm, Mm, Mm, Mm, Mm, Mm, Mm, Mm, Mm, Mm, Mm, Mm, Mm, Mm, Mm, Mm, Mm, Mm, Mm, Mm, Mm, Mm, Mm, Mm, Mm, Ww, Mm, Mm, Mm, Mm, Mm, Mm, Mm, Mm, Mm, Mm, Mm, Mm, Mm, Mm, Mm, Mm, Mm, Mm, Mm, Mm, Mm, Mm, Mm, Mm, Mm, Mm, Mm, Mm, Mm, Mm, Hh^Fms, Mm, Hh^Fms, Hh^Fms, Hh^Fms, Hh^Fms, Hh^Fms, Mm, Hh^Fms, Mm, Hh^Fms, Hh^Fms, Gs^Fms
Mm, Mm, Mm, Mm, Mm, Mm, Hh^Fms, Hh^Fms, Hh^Fms, Hh^Fms, Hh^Fms, Hh^Fms, Hh^Fms, Hh^Fms, Mm, Mm, Mm, Mm, Mm, Mm, Mm, Mm, Mm, Mm, Mm, Mm, Mm, Mm, Mm, Mm, Mm, Mm, Hh^Fms, Mm, Hh^Fms, Mm, Mm, Mm, Mm, Mm, Mm, Mm, Mm, Mm, Mm, Mm, Mm, Mm, Mm, Mm, Mm, Ww, Ww, Mm, Mm, Mm, Mm, Mm, Mm, Mm, Mm, Mm, Mm, Mm, Mm, Mm, Mm, Mm, Hh^Fms, Hh^Fms, Hh^Fms, Mm, Hh^Fms, Mm, Hh^Fms, Hh^Fms, Hh^Fms, Mm, Hh^Fms, Hh^Fms, Hh^Fms, Hh^Fms, Hh^Fms, Hh^Fms, Hh^Fms, Hh^Fms, Hh^Fms, Hh^Fms, Gs^Fms, Hh^Fms, Gs^Fms, Hh^Fms, Gs^Fms, Gs^Fms, Gs^Fms
Hh^Fms, Mm, Hh^Fms, Hh^Fms, Hh^Fms, Hh^Fms, Hh^Fms, Hh^Fms, Gs^Fms, Hh^Fms, Gs^Fms, Gs^Fms, Gs^Fms, Hh^Fms, Hh^Fms, Mm, Mm, Mm, Mm, Mm, Mm, Mm, Mm, Mm, Mm, Mm, Mm, Mm, Hh^Fms, Mm, Hh^Fms, Hh^Fms, Gs^Fms, Hh^Fms, Gs^Fms, Hh^Fms, Mm, Mm, Mm, Mm, Co, Co, Ko, Mm, Mm, Mm, Mm, Mm, Mm, Mm, Mm, Mm, Ww, Mm, Mm, Mm, Mm, Mm, Mm, Mm, Mm, Mm, Hh^Fms, Hh^Fms, Hh^Fms, Hh^Fms, Hh^Fms, Hh^Fms, Gs^Fms, Hh^Fms, Gs^Fms, Hh^Fms, Hh^Fms, Hh^Fms, Hh^Fms, Hh^Fms, Gs^Fms, Hh^Fms, Gs^Fms, Gs^Fms, Gs^Fms, Gs^Fms, Gs^Fms, Gs^Fms, Gs^Fms, Gs^Fms, Gs^Fms, Gs^Fms, Ww, Gs^Fms, Ww, Ww, Ww, Gs^Fms, Gs^Fms
Gs^Fms, Hh^Fms, Hh^Fms, Hh^Fms, Gs^Fms, Hh^Fms, Gs^Fms, Gs^Fms, Gs, Gs^Fms, Gs, Gs^Fms, Gs^Fms, Gs^Fms, Gs^Fms, Hh^Fms, Hh^Fms, Mm, Hh^Fms, Mm, Mm, Mm, Mm, Mm, Mm, Mm, Mm, Mm, Hh^Fms, Hh^Fms, Gs^Fms, Gs^Fms, Gs^Fms, Gs^Fms, Gs, Hh^Fms, Hh^Fms, Mm, Mm, Mm, Co, Co, Co, Mm, Hh^Fms, Mm, Mm, Mm, Mm, Mm, Mm, Mm, Ww, Mm, Mm, Mm, Mm, Hh^Vhh, Hh^Fms, Hh^Fms, Hh^Fms, Hh^Fms, Gs^Fms, Gs^Fms, Gs^Fms, Gs^Fms, Gs^Fms, Gs^Fms, Gs^Fms, Gs^Fms, Gs^Fms, Gs^Fms, Gs^Fms, Gs^Fms, Gs^Fms, Gs^Fms, Gs, Gs^Fms, Ww, Ww, Ww, Ww, Ww, Ww, Ww, Ww, Ww, Ww, Wo, Ww, Ww, Ww, Ww, Ww, Gs^Fms
Gs, Gs^Fms, Gs^Fms, Gs^Fms, Ce, Gs^Fms, Gs, Gs, Re^Vct, Gs, Gs, Gs, Gs, Gs, Gs, Gs^Fms, Gs^Fms, Hh^Fms, Hh^Fms, Hh^Fms, Hh^Fms, Hh^Fms, Hh^Fms, Mm, Hh^Fms, Mm, Hh^Fms, Hh^Fms, Gs^Fms, Gs^Fms, Gs, Gs, Gs, Gs, Gs, Gs^Fms, Gs^Fms, Hh^Vhh, Hh^Fms, Hh^Fms, Hh^Fms, Co, Gs^Fms, Hh^Fms, Gs^Fms, Hh^Vhh, Mm, Mm, Mm, Mm, Ww, Ww, Mm, Mm, Mm, Mm, Hh^Fms, Hh^Fms, Gs^Fms, Gs^Fms, Gs^Fms, Gs^Fms, Gs, Gs^Fms, Gs^Fms, Gs^Fms, Gs, Gs^Fms, Gs, Gs, Gs, Gs, Gs, Gs, Gs, Gs, Ww, Ww, Ww, Ww, Wo, Ww, Ds, Ds, Ds, Ww, Ww, Wo, Ww, Wo, Ww, Wo, Wo, Ww, Gs^Fms
Gs, Gs, Gs, Ce, 1 Ke, Ce, Gs, Gs, Gs, Gs, Gs, Gs, Gs, Gs, Gs, Gs, Gs, Gs^Fms, Gs^Fms, Hh^Fms, Gs^Fms, Hh^Fms, Gs^Fms, Hh^Fms, Gs^Fms, Hh^Fms, Gs^Fms, Gs^Fms, Gs, Gs, Gs, Gs, Gs, Gs, Gs, Gs, Ww, Gs^Fms, Gs^Fms, Gs^Fms, Gs^Fms, Gs^Fms, Gll, Gs^Fms, Gs^Fms, Hh^Fms, Mm, Mm, Mm, Ww, Ww, Mm, Mm, Mm, Hh^Fms, Hh^Fms, Gs^Fms, Gs^Fms, Gs, Gs, Gs, Gs, Gs, Gs, Gs, Gs, Gs, Gs, Gs, Gs, Gs, Gs, Ww, Gs, Gs, Gs, Ww, Ww, Wo, Ww^Vm, Ww, Ww, Gll^Ftr, Gll^Ftr, Gll^Ftr, Ds, Gll^Ftr, Ww, Gll^Ftr, Ww, Ww, Ww, Wo, Ww, Ww
Gs, Re^Vct, Gs, Ce, Ce, Ce, Ww, Ww, Ww, Ww, Ww, Ww, Ww, Gs, Ww, Gs, Gs, Gs, Gs, Gs^Fms, Gs, Gs^Fms, Gs^Fms, Gs^Fms, Gs, Gs^Fms, Gs, Gs, Ww, Ww, Ww, Ww, Ww, Ww, Ww, Ww, Wo, Ww, Wwf, Ww, Ww, Ww, Ww, Gll, Gs^Fms, Hh^Fms, Hh^Fms, Mm, Ww, Ww, Ww, Mm, Mm, Hh^Fms, Gs^Fms, Gs^Fms, Gs, Gs, Gs, Gs, Ww, Ww, Ww, Gs, Ww, Gs, Ww, Gs, Gs, Gs, Wwf, Ww, Wo, Ww, Ww, Gs^Vc, Ww, Ww, Wo, Ww, Ds, Gll^Ftr, Gll^Ftr, Gll^Ftr, Gll^Ftr, Gll^Ftr, Gll^Ftr, Gll^Ftr, Gll^Ftr, Gll^Ftr, Ds, Ww, Ww, Wo, Ww
Gs, Gs, Ww, Ww, Ww, Ww, Wo, Wo, Wo, Wo, Ww, Wo, Wo, Ww, Ww, Ww, Ww, Gd^Vo, Gs, Gs, Gs, Gs, Gs, Gs^Fms, Gs, Gs, Ww, Ww, Wo, Wo, Wo, Ww, Ww, Wo, Wo, Wo, Wo, Ww, Wwf, Ww, Wo, Wo, Wo, Ww, Ww, Gs^Fms, Gs^Fms, Hh^Fms, Ww, Ww, Ww, Mm, Hh^Fms, Hh^Fms, Gs^Fms, Gs, Ww, Gs, Ww, Wwf, Wwf, Ww, Wo, Ww, Wo, Ww, Wo, Ww, Ww, Wwf, Wwf, Wwf, Wwf, Wo, Wo, Ww, Wo, Wo, Wo, Ww, Gll^Ftr, Gll^Ftr, Gll^Ftr, Gg^Ve, Gll^Ftr, Gll^Ftr, Cv, Gll^Ftr, Gll^Ftr, Gll^Ftr, Gll^Ftr, Ds, Ww, Wo, Ww
Ww, Ww, Wo, Wo, Wo, Wo, Ww, Ww, Ww, Ww, Gs, Ww, Ww, Wo, Wo, Wo, Wo, Ww, Wwf, Gs, Ww, Gs, Ww, Gs, Ww, Ww, Wo, Wo, Wo, Wo, Ww, Ww, Gs, Ww, Ww, Ww, Ww, Ww, Wwf, Ww, Ww, Ww, Ww, Wo, Wo, Ww, Ww, Ww^Ewl, Ww^Ewl, Ww, Ww^Ewl, Hh^Fms, Gs^Fms, Gs^Fms, Ww, Ww, Wo, Ww, Wo, Ww, Wwf, Ww, Ww, Wo, Ww, Wo, Wo, Wo, Ww, Ww, Ww, Wwf, Gs, Ww, Ww, Wo, Wo, Ww^Vm, Wo, Ww, Gll^Ftr, Gll^Ftr, Gll^Ftr, Gll^Ftr, Gll^Ftr, Cv, Kv, Cv, Gll^Ftr, Gll^Ftr, Gg^Ve, Gll^Ftr, Ww, Wo, Ww
Ww, Wo, Ww, Ww, Ww, Ww, Gs, Gs, Gs, Gs, Gs^Fms, Gs, Gs, Ww, Ww, Wo, Wo, Ww, Wwf, Wwf, Ww, Ww, Wo, Ww, Wo, Wo, Ww, Ww, Ww, Ww, Gs, Gs, Gs^Fms, Gs, Gs, Gs, Gs, Gs^Fms, Gs^Fms, Gs^Fms, Gll, Ds, Ds, Ww, Ww, Ww, Wo, Wo, Wo, Ww^Ewl, Wo, Ww^Ewl, Ww, Ww, Wo, Wo, Wo, Wo, Ww, Ww, Gs, Gs, Gs, Ww, Gs, Ww, Ww, Ww, Gs, Ww, Gs, Gs, Gs, Gs, Gs, Ww, Ww, Wo, Wo, Ww, Ds, Gll^Ftr, Gll^Ftr, Gll^Ftr, Gll^Ftr, Cv, Cv, Cv, Gll^Ftr, Gll^Ftr, Gll^Ftr, Gll^Ftr, Ww, Wo, Ww
Gs, Ww, Gs, Ww, Gs, Gs, Gs, Gs, Gs^Fms, Gs^Vc, Gs^Fms, Gll, Gll, Gs, Ww, Wo, Ww, Ww, Co, Wwf, Ww, Wo, Ww, Ww, Ww, Ww, Gs^Fms, Gs^Fms, Gs^Fms, Gs, Gs^Fms, Gs^Fms, Hh^Fms, Gs^Fms, Gs^Fms, Gs^Fms, Hh^Fms, Gs^Fms, Hh^Fms, Gs^Fms, Gs^Fms, Gll, Gll, Gll, Gll, Ww, Ww, Ww, Ww, Wo, Wo, Wo, Wo, Wo, Ww, Wo, Ww, Ww, Gs, Gs, Gs, Gs, Gs, Gs, Gs, Gs, Gs, Gs, Gs, Gs, Gs, Gs, Gs, Gs, Gs, Gs, Gs, Ww, Wo, Ww, Ds, Gll^Ftr, Gll^Ftr, Gll^Ftr, Gll^Ftr, Gll^Ftr, Gll^Ftr, Gll^Ftr, Gll^Ftr, Gll^Ftr, Gll^Ftr, Gll^Ftr, Ww, Wo, Ww
Gs, Gs, Gs, Gs, Gs, Gs, Gs^Fms, Gs^Fms, Hh^Fms, Hh^Fms, Hh^Fms, Gs^Fms, Gs^Fms, Gll, Gs^Fms, Ww, Ww, Co, Co, Co, Gs^Fms, Ww, Gd^Vo, Ww, Gs^Fms, Gll, Gs^Fms, Hh^Fms, Hh^Fms, Gs^Fms, Hh^Fms, Hh^Fms, Hh^Fms, Hh^Fms, Hh^Fms, Hh^Fms, Hh^Fms, Hh^Fms, Hh^Fms, Hh^Fms, Hh^Fms, Gs^Fms, Gs^Fms, Gs^Fms, Gs^Fms, Gs^Fms, Cud, Gs^Fms, Gs^Fms, Ww, Ww, Ww, Ww, Ww, Gs^Fms, Ww, Ww, Gs^Fms, Gs^Fms, Gs, Gs^Fms, Gs^Fms, Gs^Fms, Gs^Fms, Gs^Fms, Gs, Gs^Fms, Gs, Gs, Gs, Gs^Fms, Gs, Gs, Gs, Gs, Gs, Gs, Ww, Ww, Ww, Ww, Gll^Ftr, Gll^Ftr, Gll^Ftr, Gll^Ftr, Gll^Ftr, Gll^Ftr, Gg^Ve, Gll^Ftr, Gll^Ftr, Gll^Ftr, Ds, Ww, Wo, Ww
Gs, Gs, Gs^Fms, Gs, Gs^Fms, Gs^Fms, Hh^Fms, Hh^Fms, Mm, Hh^Fms, Mm, Hh^Fms, Hh^Fms, Gs^Fms, Gs^Fms, Ww, Gs^Fms, Co, Ko, Co, Hh^Fms, Gs^Fms, Gs^Fms, Gs^Fms, Hh^Fms, Gs^Fms, Hh^Fms, Hh^Fms, Hh^Fms, Hh^Fms, Hh^Fms, Hh^Fms, Hh^Fms, Hh^Fms, Mm, Hh^Fms, Hh^Fms, Hh^Fms, Mm, Hh^Fms, Hh^Fms, Hh^Fms, Hh^Fms, Hh^Fms, Cud, Hh^Fms, Mm, Hh^Fms, Cud, Ss, Ss, Ss^Emf, Ss, Gs^Fms, Hh^Fms, Gs^Fms, Hh^Fms, Ww, Ww, Gs^Fms, Hh^Fms, Hh^Fms, Hh^Fms, Gs^Fms, Hh^Fms, Gs^Fms, Hh^Fms, Gs^Fms, Gs^Fms, Gs^Fms, Hh^Fms, Gs^Fms, Gs^Fms, Gs^Fms, Gs, Gs, Gs, Ww, Ww, Ww, Wo, Ww, Ww, Ds, Ds, Gll^Ftr, Gll^Ftr, Gll^Ftr, Gll^Ftr, Gll^Ftr, Ww, Ww, Wo, Ww, Ww
Gs, Gs, Gs^Fms, Gs^Fms, Gs^Fms, Hh^Fms, Hh^Fms, Mm, Mm, Mm, Mm, Mm, Hh^Fms, Hh^Fms, Gs^Fms, Ww, Gs^Fms, Hh^Fms, Hh^Fms, Hh^Fms, Hh^Fms, Hh^Fms, Hh^Fms, Hh^Fms, Hh^Fms, Hh^Fms, Hh^Fms, Hh^Fms, Hh^Fms, Hh^Fms, Hh^Vhh, Hh^Fms, Mm, Mm, Mm, Mm, Mm, Mm, Mm, Mm, Mm, Hh^Fms, Hh^Vhh, Hh^Fms, Mm, Mm, Cud, Mm, Mm, Hh^Fms, Hh^Fms, Ss, Hh^Fms, Hh^Fms, Hh^Fms, Hh^Fms, Hh^Fms, Hh^Fms, Ww, Hh^Fms, Hh^Fms, Hh^Fms, Mm, Hh^Fms, Hh^Vhh, Hh^Fms, Mm, Hh^Fms, Hh^Fms, Hh^Fms, Mm, Hh^Fms, Hh^Fms, Gs^Fms, Gs^Fms, Gs, Gs, Gs, Gs^Fms, Ww, Ww, Ww, Ww, Ww, Ww, Ds, Ww, Gll^Ftr, Ww, Ww, Ww, Ww^Vm, Ww, Ww, Ww
Gs^Fms, Gs^Fms, Hh^Fms, Hh^Fms, Hh^Fms, Hh^Fms, Hh^Fms, Mm, Mm, Mm, Mm, Mm, Hh^Fms, Hh^Fms, Hh^Fms, Ww, Hh^Fms, Hh^Fms, Mm, Hh^Fms, Hh^Fms, Hh^Fms, Hh^Fms, Hh^Fms, Hh^Fms, Hh^Fms, Hh^Fms, Hh^Fms, Mm, Mm, Mm, Mm, Mm, Mm, Mm, Mm, Mm, Mm, Mm, Mm, Mm, Mm, Mm, Mm, Mm, Cud, Kud, Cud, Mm, Mm, Mm, Hh^Fms, Hh^Fms, Hh^Fms, Hh^Fms, Hh^Fms, Hh^Fms, Hh^Fms, Ww, Hh^Fms, Mm, Mm, Mm, Mm, Mm, Mm, Mm, Mm, Mm, Mm, Mm, Mm, Mm, Hh^Fms, Hh^Fms, Gs^Fms, Gs^Fms, Gs^Fms, Gs^Fms, Ww, Ww, Ww, Ww, Ww, Ww, Ww, Wo, Ww, Wo, Ww, Ww, Ww, Ww, Ww, Ww
Hh^Fms, Hh^Fms, Hh^Fms, Hh^Fms, Hh^Fms, Hh^Fms, Mm, Mm, Mm, Mm, Mm, Mm, Mm, Hh^Fms, Hh^Fms, Ww, Mm, Mm, Mm, Mm, Mm, Hh^Fms, Hh^Fms, Hh^Fms, Hh^Fms, Hh^Fms, Mm, Mm, Mm, Mm, Mm, Mm, Mm, Mm, Mm, Mm, Mm, Mm, Mm, Mm, Mm, Mm, Mm, Mm, Mm, Cud, Cud, Cud, Mm, Mm, Mm, Mm, Hh^Vhh, Hh^Fms, Mm, Mm, Mm, Mm, Ww, Ww, Mm, Mm, Mm, Mm, Mm, Mm, Mm, Mm, Mm, Mm, Mm, Mm, Mm, Mm, Hh^Fms, Gs^Fms, Gs^Fms, Gs^Fms, Gs^Fms, Gs^Fms, Gs^Fms, Ww, Hh^Fds, Hh^Fds, Hh^Fds, Ww, Ww, Wo, Wo, Ww, Hh^Fds, Ww, Hh^Fds, Hh^Fds, Hh^Fds
Hh^Fms, Hh^Fms, Mm, Hh^Fms, Mm, Mm, Mm, Mm, Mm, Mm, Mm, Mm, Mm, Mm, Mm, Ww, Mm, Mm, Mm, Mm, Mm, Mm, Hh^Fms, Hh^Fms, Mm, Mm, Mm, Mm, Mm, Mm, Mm, Mm, Mm, Mm, Mm, Mm, Mm, Mm, Mm, Mm, Mm, Mm, Mm, Mm, Mm, Mm, Mm, Mm, Mm, Mm, Mm, Mm, Mm, Mm, Mm, Mm, Mm, Ww, Mm, Mm, Mm, Mm, Mm, Mm, Mm, Mm, Mm, Mm, Mm, Mm, Mm, Mm, Mm, Mm, Hh^Fms, Hh^Fms, Hh^Fms, Gs^Fms, Hh^Fms, Gs^Fms, Hh^Fms, Hh^Fms, Hh^Fds, Hh^Fds, Hh^Fds, Hh^Fds, Ww, Wo, Wo, Ww, Hh^Fds, Hh^Fds, Hh^Fds, Hh^Fds, Hh^Fds
Mm, Mm, Mm, Mm, Mm, Mm, Mm, Mm, Mm, Mm, Mm^Xm, Mm, Mm, Mm, Mm, Ww, Mm, Mm, Mm^Xm, Mm, Mm, Mm, Mm, Mm, Mm, Mm, Mm, Mm, Mm, Mm, Mm, Mm, Mm, Mm, Mm, Mm, Mm, Mm, Mm, Mm, Mm, Mm, Mm, Hh^Vhh, Mm, Mm, Mm, Mm, Mm, Mm, Mm, Mm, Mm, Mm, Mm, Mm, Ww, Ww, Mm, Mm, Mm, Mm, Mm, Mm, Mm, Mm, Mm, Mm, Mm, Mm, Mm, Mm, Mm, Mm, Mm, Hh^Fms, Hh^Vhh, Hh^Fms, Mm, Hh^Fms, Mm, Mm, Mm, Hh^Fds, Mm, Hh^Fds, Ww, Wo, Wo, Ww, Hh^Fds, Hh^Fds, Hh^Fds, Hh^Fds, Hh^Fds
Mm, Mm, Mm^Xm, Mm, Mm^Xm, Mm, Mm, Mm, Mm, Mm, Mm^Xm, Mm, Mm, Mm, Mm, Ww, Hh^Fds, Mm, Mm, Mm, Mm, Mm, Mm, Mm, Mm, Mm, Mm, Mm, Mm, Mm, Mm, Mm, Mm^Xm, Mm, Mm, Mm, Mm, Mm, Mm, Mm, Mm, Mm, Mm, Mm, Mm, Mm, Mm, Mm, Mm, Mm, Mm, Mm, Mm, Mm, Mm, Mm, Ww, Ww, Mm, Mm, Mm, Mm, Mm, Mm, Mm, Mm, Mm, Mm, Mm, Mm, Mm, Mm, Mm, Mm, Mm, Mm, Mm, Mm, Mm, Mm, Mm, Mm, Mm, Mm, Mm, Hh, Ww, Wo, Ww, Hh^Fds, Hh, Mm, Mm, Mm, Mm
Mm, Mm^Xm, Mm, Mm, Mm, Mm^Xm, Mm, Mm, Mm, Mm, Mm^Xm, Mm, Mm, Mm, Ww, Ww, Mm, Mm, Mm, Mm, Mm, Mm, Mm, Mm, Mm, Mm, Mm, Mm, Mm, Mm, Mm, Mm^Xm, Mm, Mm, Mm, Mm^Xm, Mm^Xm, Mm, Mm, Mm, Mm, Mm, Mm, Mm, Mm, Mm, Mm, Mm, Mm, Mm, Mm, Mm, Mm, Mm, Mm, Mm, Ww, Mm, Mm, Mm, Mm, Mm, Mm, Mm, Mm, Mm, Mm, Mm, Mm, Mm, Mm, Mm, Mm, Mm, Mm, Mm, Mm, Mm, Mm, Mm, Mm, Mm, Mm, Mm, Mm, Hh, Ww, Wo, Ww, Hh, Mm, Mm, Mm, Mm, Mm
Mm, Mm, Mm, Mm, Mm, Mm^Xm, Mm^Xm, Mm, Mm, Mm, Mm, Mm, Mm, Ww, Mm, Mm, Mm, Mm, Mm, Mm, Mm, Mm, Mm, Mm, Mm, Mm, Mm^Xm, Mm^Xm, Mm, Mm, Mm^Xm, Mm^Xm, Mm, Mm, Mm^Xm, Mm^Xm, Mm, Mm, Mm, Mm, Mm, Mm, Mm, Mm, Mm^Xm, Mm, Mm, Mm, Mm, Mm, Mm, Mm, Mm, Mm, Ww, Ww, Mm, Mm, Mm, Mm, Mm, Mm, Mm, Mm, Mm, Mm, Mm, Mm, Mm, Mm, Mm, Mm, Mm, Mm, Mm, Mm, Mm, Mm, Mm, Mm, Mm, Mm, Mm, Mm, Mm, Hh^Fds, Hh^Fds, Ww, Ww, Hh, Mm, Mm, Mm, Mm, Mm
Mm, Mm, Mm, Mm, Mm, Mm, Mm, Mm^Xm, Mm^Xm, Mm, Mm, Mm, Mm, Ww, Ww, Mm, Mm, Mm, Mm, Mm, Mm, Mm, Mm, Mm, Mm, Mm^Xm, Mm^Xm, Mm, Mm^Xm, Mm^Xm, Mm^Xm, Mm, Mm^Xm, Mm^Xm, Mm, Mm, Mm, Mm, Mm^Xm, Mm, Mm^Xm, Mm^Xm, Mm, Mm^Xm, Mm, Mm^Xm, Mm, Mm^Xm, Mm^Xm, Mm, Mm, Mm, Ww, Ww, Mm, Mm, Mm, Mm, Mm, Mm, Mm, Mm, Mm, Mm, Mm, Mm, Mm, Mm, Mm, Mm, Mm, Mm, Mm, Mm, Mm, Mm, Mm, Mm, Mm, Mm, Mm, Mm, Mm, Mm, Mm, Hh^Fds, Hh^Fds, Ww, Ww, Hh, Mm, Mm, Mm, Mm, Mm
Mm, Mm, Mm, Mm, Mm, Mm, Mm, Mm, Mm, Mm, Mm, Mm, Mm, Ww, Ww, Mm, Mm, Mm, Mm, Mm^Xm, Mm, Mm, Mm, Mm, Mm, Mm, Mm, Mm, Mm, Mm^Xm, Mm, Mm, Mm, Mm, Mm, Mm, Mm, Mm^Xm, Mm, Mm, Mm, Mm, Mm, Mm, Mm, Mm, Mm, Mm, Mm, Mm^Xm, Mm, Ww, Mm, Mm, Mm, Mm, Mm, Mm, Mm, Mm, Mm, Mm, Mm, Mm, Mm, Mm, Mm, Mm, Mm, Mm, Mm, Mm, Mm, Mm, Mm, Mm, Mm, Mm, Mm, Mm, Mm, Mm, Mm, Mm, Mm, Hh^Fds, Ww, Ww, Ww, Hh, Mm, Mm, Mm, Mm, Mm
Mm, Mm, Mm, Mm, Mm, Mm, Mm, Mm, Mm, Mm, Mm, Mm^Xm, Mm^Xm, Mm, Mm, Ww, Ww, Mm, Mm, Mm, Mm, Mm, Mm, Mm, Mm, Mm, Mm, Mm, Mm, Mm, Mm, Mm, Mm, Mm, Mm, Mm, Mm, Mm, Mm, Mm, Mm, Mm, Mm, Mm, Mm, Mm, Mm, Mm, Mm, Mm, Mm, Ww, Mm, Mm, Mm, Mm, Mm, Mm, Mm, Mm, Mm, Mm, Mm, Mm, Mm, Mm, Mm, Mm, Mm, Mm, Mm, Mm, Mm, Mm, Mm, Mm, Mm, Mm, Mm^Xm, Mm, Mm, Mm, Mm, Mm, Mm, Hh, Ww, Wo, Ww, Hh, Mm, Mm, Mm, Mm, Mm
Mm, Mm, Mm^Xm, Mm, Mm, Mm, Mm^Xm, Mm, Mm, Mm, Mm, Mm, Mm, Mm^Xm, Mm, Mm, Ww, Mm, Mm, Mm, Mm, Mm, Mm^Xm, Mm^Xm, Mm, Mm^Xm, Mm^Xm, Mm^Xm, Mm^Xm, Mm, Mm, Mm, Mm, Mm, Mm^Xm, Mm^Xm, Mm^Xm, Mm^Xm, Mm, Mm, Mm, Mm, Mm, Mm, Mm, Mm, Mm, Mm, Mm, Mm, Mm, Ww, Ww, Mm, Mm^Xm, Mm^Xm, Mm^Xm, Mm, Mm, Mm, Mm, Mm, Mm, Mm, Mm^Xm, Mm, Mm^Xm, Mm, Mm, Mm, Mm, Mm, Mm, Mm, Mm, Mm, Mm^Xm, Mm^Xm, Mm, Mm, Mm, Mm, Mm, Mm, Hh, Hh, Ww, Ww, Hh, Hh, Mm, Mm, Mm, Mm, Mm
Mm, Mm^Xm, Mm, Mm^Xm, Mm, Mm, Mm, Mm^Xm, Mm^Xm, Mm^Xm, Mm^Xm, Mm, Mm, Mm, Mm, Mm, Ww, Mm, Mm, Mm, Mm, Mm^Xm, Mm, Mm, Mm, Mm, Mm, Mm, Mm, Mm, Mm, Mm, Mm, Mm, Mm^Xm, Mm^Xm, Mm, Mm, Mm, Mm^Xm, Mm^Xm, Mm, Mm, Mm, Mm, Mm, Mm, Mm^Xm, Mm, Mm, Mm, Mm, Ww, Mm, Mm, Mm, Mm, Mm^Xm, Mm, Mm, Mm, Mm, Mm, Mm, Mm, Mm^Xm, Mm, Mm^Xm, Mm, Mm, Mm, Mm, Mm, Mm, Mm, Mm^Xm, Mm, Mm, Mm, Mm, Mm, Mm, Mm, Hh, Ww, Ww, Ww, Ww, Hh, Hh^Fds, Mm, Mm, Mm, Mm, Mm
Mm, Mm, Mm, Mm, Mm, Mm, Mm, Mm, Mm, Mm, Mm^Xm, Mm, Mm, Mm, Mm, Mm, Ww, Mm, Mm, Mm, Mm, Mm^Xm, Mm, Mm, Mm, Mm, Mm, Mm, Mm^Xm, Mm^Xm, Mm^Xm, Mm^Xm, Mm^Xm, Mm^Xm, Mm^Xm, Mm^Xm, Mm^Xm, Mm, Mm, Mm, Mm, Mm, Mm, Mm, Mm, Mm, Mm, Mm^Xm, Mm^Xm, Mm, Mm, Ww, Mm, Mm, Mm, Mm, Mm, Mm, Mm, Mm, Mm^Xm, Mm, Mm, Mm, Mm, Mm, Mm, Mm^Xm, Mm^Xm, Mm, Mm, Mm, Mm^Xm, Mm^Xm, Mm^Xm, Mm^Xm, Mm, Mm, Mm, Mm, Mm, Mm, Hh^Fds, Hh, Ww, Wo, Ww, Hh, Hh^Fds, Hh^Fds, Mm, Mm, Mm, Mm, Mm
Mm^Xm, Mm, Mm^Xm, Mm, Mm^Xm, Mm, Mm^Xm, Mm, Mm^Xm, Mm, Mm, Mm, Mm, Mm, Ww, Ww, Mm, Mm, Mm, Mm, Mm^Xm, Mm, Mm, Mm, Mm, Mm, Mm, Mm^Xm, Mm, Mm, Mm^Xm, Mm^Xm, Mm^Xm, Mm, Mm, Mm, Mm, Mm, Mm^Xm, Mm, Mm, Mm^Xm, Mm^Xm, Mm, Mm, Mm, Mm, Mm, Mm, Mm^Xm, Mm, Mm, Mm, Mm, Mm, Mm, Mm, Mm, Mm, Mm, Mm^Xm, Mm^Xm, Mm, Mm, Mm, Mm, Mm, Mm, Mm, Mm^Xm, Mm^Xm, Mm^Xm, Mm, Mm, Mm, Mm, Mm, Mm, Mm, Mm, Mm, Hh^Fds, Hh, Ww, Ww, Ww, Hh^Fds, Hh, Mm, Mm, Mm, Mm, Mm, Mm, Mm
Mm, Mm^Xm, Mm, Mm, Mm, Mm^Xm, Mm, Mm^Xm, Mm, Mm, Mm, Mm, Mm, Mm, Ww, Mm, Mm, Mm, Mm, Mm^Xm, Mm^Xm, Mm, Mm, Mm, Mm, Mm, Mm^Xm, Mm^Xm, Mm, Mm^Xm, Mm, Mm, Mm, Mm, Mm, Mm, Mm, Mm, Mm, Mm, Mm, Mm, Mm, Mm^Xm, Mm^Xm, Mm, Mm^Xm, Mm, Mm, Mm, Mm^Xm, Mm, Mm, Mm, Mm, Mm, Mm, Mm, Mm, Mm^Xm, Mm, Mm, Mm, Mm, Mm, Mm, Mm, Mm, Mm, Mm, Mm, Mm, Mm, Mm, Mm, Mm, Mm, Mm, Mm, Mm, Mm, Hh^Fds, Hh, Ww, Ww, Hh^Fds, Hh^Fds, Mm, Mm, Mm, Mm, Mm, Mm, Mm, Mm
Mm, Mm, Mm, Mm, Mm, Mm, Mm, Mm, Mm, Mm, Mm, Mm, Mm, Mm, Ww, Mm, Mm, Mm, Mm, Mm, Mm, Mm^Xm, Mm, Mm, Mm, Mm^Xm, Mm, Mm, Mm, Mm, Mm, Mm, Mm, Mm, Mm, Mm, Mm, Mm, Mm, Mm, Mm, Mm, Mm, Mm, Mm, Mm, Mm, Mm^Xm, Mm, Mm, Mm, Mm, Mm^Xm, Mm, Mm^Xm, Mm, Mm^Xm, Mm, Mm^Xm, Mm^Xm, Mm, Mm, Mm, Mm, Mm, Mm, Mm, Mm, Mm, Mm, Mm, Mm, Mm, Mm, Mm, Mm, Mm, Mm, Mm, Mm, Mm, Hh^Fds, Ww, Ww, Ww, Hh^Fds, Hh^Fds, Mm, Mm, Mm, Mm, Mm, Mm, Mm, Mm
Mm, Mm, Mm, Mm, Mm, Mm, Mm, Mm, Mm, Mm, Mm, Mm, Mm, Mm, Mm, Ww, Ww, Mm, Mm, Mm, Mm, Mm, Mm, Mm, Mm, Mm, Mm, Mm, Mm, Mm, Mm, Mm, Mm, Mm, Mm, Mm, Mm, Mm, Mm, Mm, Mm, Mm, Mm, Mm, Mm, Mm, Mm, Mm, Mm, Mm, Mm, Mm, Mm, Mm^Xm, Mm, Mm^Xm, Mm, Mm^Xm, Mm, Mm, Mm, Mm, Mm, Mm, Mm, Mm, Mm, Mm, Mm, Mm, Mm, Mm, Mm, Mm, Mm, Mm, Mm, Mm, Mm, Mm, Mm, Mm, Ww, Wo, Wo, Ww, Hh^Fds, Mm, Mm, Mm, Mm, Mm, Mm, Mm, Mm
