Wot, Wot, Wot, Wot, Wot, Wot, Wot, Wot, Wot, Wot, Wot, Wot, Wot, Wot, Wot, Wot, Wot, Wot, Wot, Wot, Wot, Wot, Wot, Wot, Wot, Wot, Wot, Wot, Wot, Wot, Wot, Wot, Wot, Wot, Wot, Wot, Wot, Wot, Wot, Wot, Wot, Wot, Wot, Wot, Wot, Wot, Wot, Wot, Wot, Wot, Wot, Wot, Wot, Wot, Wot, Wot, Wot, Wot
Wot, Wot, Wot, Wot, Wot, Wot, Wot, Wot, Wot, Wot, Wot, Wot, Wot, Wot, Wot, Wot, Wot, Wot, Wot, Wot, Wot, Wot, Wot, Wot, Wot, Wot, Wot, Wot, Wot, Wot, Wot, Wot, Wot, Wot, Wot, Wot, Wot, Wot, Wot, Wot, Wot, Wot, Wot, Wot, Wot, Wot, Wot, Wot, Wot, Wot, Wot, Wot, Wot, Wot, Wot, Wot, Wot, Wot
Wot, Wot, Wot, Wot, Wot, Wot, Wwt, Wwt, Wwt, Wwt, Wwt, Wwt, Wwt, Wot, Wot, Wot, Wot, Wot, Wot, Wot, Wot, Wot, Wot, Wot, Wot, Wot, Wot, Wot, Wot, Wot, Wot, Wot, Wot, Wot, Wot, Wot, Wot, Wot, Wot, Wot, Wot, Wot, Wot, Wot, Wot, Wot, Wot, Wot, Wot, Wot, Wot, Wot, Wot, Wot, Wot, Wot, Wot, Wot
Wot, Wot, Wot, Wot, Wot, Wwt, Wwt, Wwt, Ds, Wwt, Ds, Wwt, Ds, Wwt, Wwt, Wot, Wwt, Wwt, Wwt, Wot, Wot, Wot, Wot, Wot, Wot, Wot, Wot, Wot, Wot, Wot, Wot, Wot, Wot, Wwrt, Wot, Wwrt, Wot, Wot, Wot, Wot, Wot, Wot, Wot, Wot, Wot, Wot, Wot, Wot, Wot, Wot, Wot, Wot, Wot, Wot, Wot, Wot, Wot, Wot
Wot, Wot, Wwt, Wwt, Wwt, Wwt, Ds, Ds, Gs^Ft, Ds, Gs^Ft, Ds, Gs^Ft, Ds, Ds, Wwt, Ds, Wwt, Wwt, Wwt, Wot, Wot, Wot, Wot, Wot, Wot, Wot, Wot, Wot, Wot, Wot, Wot, Wot, Wot, Wot, Wot, Wot, Wot, Wot, Wwrt, Wwrt, Wot, Wot, Wot, Wot, Wot, Wot, Wot, Wot, Wot, Wot, Wot, Wot, Wot, Wot, Wot, Wot, Wot
Wwt, Wot, Wwt, Wwt, Ds, Ds, Ds, Gs^Ft, Gs^Ft, Gs^Ft, Hh^Ft, Gs^Ft, Gs^Ft, Gs^Ft, Gs^Ft, Ds, Gs^Ft, Ds, Ds, Wwt, Wwt, Wot, Wot, Wot, Wot, Wot, Wot, Wot, Wot, Wot, Wot, Wot, Wot, Wot, Wot, Wot, Wot, Wot, Wot, Wot, Wot, Wwrt, Wwrt, Wot, Wot, Wot, Wot, Wot, Wot, Wot, Wot, Wot, Wot, Wot, Wot, Wot, Wot, Wot
Ds, Wwt, Ds, Ds, Gs^Ft, Ds, Gs^Ft, Gs^Ft, Gs^Ft, Hh^Ft, Hh^Ft, Hh^Ft, Hh^Ft, Gs^Ft, Gs^Ft, Gs^Ft, Gs^Ft, Gs^Ft, Gs^Ft, Ds, Wwt, Wot, Wwt, Wot, Wot, Wot, Wot, Wot, Wot, Wot, Wot, Wot, Wot, Wot, Wot, Wot, Wot, Wot, Wot, Wot, Wot, Wot, Wot, Wwrt, Wot, Wot, Wot, Wot, Wot, Wot, Wot, Wot, Wot, Wot, Wot, Wot, Wot, Wot
Gs^Ft, Ds, Gs^Ft, Gs^Ft, Gs^Ft, Gs^Ft, Gs^Ft, Gs^Ft, Gs^Ft, Hh^Ft, Hh^Ft, Hh^Ft, Hh^Ft, Hh^Ft, Hh^Ft, Hh^Ft, Hh^Ft, Gs^Ft, Gs^Ft, Ds, Ds, Wwt, Wwt, Wwt, Wwt, Wwt, Wwt, Wot, Wot, Wot, Wot, Wot, Wot, Wot, Wot, Wot, Wot, Wot, Wot, Wot, Wot, Wot, Wot, Wwrt, Wwrt, Wot, Wot, Wot, Wot, Wot, Wot, Wot, Wot, Wot, Wot, Wot, Wot, Wot
Hh^Ft, Gs^Ft, Gs^Ft, Gs^Ft, Gs^Ft, Gs^Ft, Gs^Ft, Gs^Ft, Gs^Ft, Gs^Ft, Gs^Ft, Hh^Ft, Hh^Ft, Hh^Ft, Hh^Ft, Hh^Ft, Hh^Ft, Gs^Ft, Gs^Ft, Gs, Gg, Ds, Ds, Wwt, Wwt, Wwt, Ds, Wwt, Wwt, Wot, Wwt, Wwt, Wot, Wot, Wot, Wot, Wot, Wot, Wot, Wot, Wot, Wot, Wot, Wot, Wot, Wot, Wot, Wot, Wot, Wot, Wot, Wot, Wot, Wot, Wot, Wot, Wot, Wot
Hh^Ft, Hh^Ft, Hh^Ft, Gs^Ft, Gs^Ft, Gs^Ft, Gs^Ft, Gs^Ft, Gs^Ft, Gs^Ft, Gs^Ft, Hh^Ft, Hh^Ft, Hh^Ft, Hh^Ft, Hh^Ft, Gs^Ft, Gs^Ft, Gll, Gs, Gg, Gg, Gg, Ds, Ds, Ds, Gs, Ds, Ds, Wwt, Wwt, Wwt, Wwt, Wot, Wot, Wot, Wot, Wot, Wot, Wot, Wot, Wot, Wot, Wot, Wot, Wot, Wot, Wot, Wot, Wot, Wot, Wot, Wot, Wot, Wot, Wot, Wot, Wot
Hh^Ft, Hh^Ft, Hh^Ft, Gs^Ft, Gll, Gs^Ft, Gll, Gll, Gll, Gs^Ft, Gs^Ft, Gs^Ft, Gs^Ft, Gs^Ft, Gs^Ft, Gs^Ft, Gs^Ft, Gs^Ft, Gs^Ft, Gs, Gg, Gg, Gs, Gg, Gs, Gs, Gs, Gs, Ds, Ds, Wwt, Wwt, Wwt, Wot, Wot, Wot, Wot, Wot, Wwt, Wot, Wot, Wot, Wot, Wot, Wot, Wot, Wot, Wot, Wot, Wot, Wot, Wot, Wot, Wot, Wot, Wot, Wot, Wot
Hh^Ft, Hh^Ft, Gs^Ft, Gs^Ft, Gs, Gs, Gg, Gg, Gs, Gs^Ft, Gs^Ft, Gs^Ft, Gs^Ft, Gs^Ft, Gs^Ft, Gs^Ft, Gs^Ft, Gs^Ft, Gs^Ft, Gs, Gg, Gs, Gg, Gs, Gs, Gs, Gg, Gs, Gg, Ds, Ds, Wwt, Ds, Wwt, Wwt, Wwt, Wwt, Wwt, Wwt, Wot, Wot, Wot, Wot, Wot, Wot, Wot, Wot, Wot, Wot, Wot, Wot, Wot, Wot, Wot, Wot, Wot, Wot, Wot
Gs^Ft, Gs^Ft, Gs^Ft, Gs^Ft, Gs, Gs, Gg, Gg, Gg, Gs, Gs, Gs, Gs, Gs, Gg, Gs, Gs, Gs^Ft, Gs, Gs, Gs, Gg, Gg, Gg^Es, Gg, Gs, Gs, Gs, Gs, Gg, Gg, Ds, Gg, Ds, Ds, Wwt, Ds, Ds, Ds, Wwt, Wwt, Wot, Wot, Wot, Wot, Wot, Wot, Wot, Wot, Wot, Wot, Wot, Wot, Wot, Wot, Wot, Wot, Wot
Gs^Ft, Gs^Ft, Gs, Gs, Gg, Gs, Gs, Gs, Gg, Gs, Gs, Gs, Gg, Gg, Gg, Gg^Es, Gg, Gs, Gg, Gg, Gg, Gg, Hh, Gg, Gg, Gg, Gg, Gg, Gg, Gg, Gs, Gs, Gs, Gg, Gs, Ds, Gs, Gs, Gs, Ds, Wwt, Wwt, Wot, Wot, Wot, Wot, Wot, Wot, Wot, Wot, Wot, Wot, Wot, Wot, Wot, Wot, Wot, Wot
Gs^Ft, Gs^Ft, Gs, Gg, Gg, Gg, Gs, Gg, Gg, Gg, Gg, Gs, Gs, Gs, Gg, Gg, Gg, Gg, Gs, Gg, Gg, Hh, Hh, Hh, Hh, Hh, Hh, Gg, Gg, Gg, Gg, Gg, Gg, Gs, Gs, Gs, Gs^Ft, Gs, Gs, Ds, Ds, Wwt, Wot, Wot, Wot, Wot, Wot, Wot, Wot, Wot, Wot, Wot, Wot, Wot, Wot, Wot, Wot, Wot
Gs, Gs, Gs, Gg, Gs, Gg, Gs, Gg, Re^Vct, Gg, Gs, Gs, Gg, Gg, Gg, Re^Vct, Gg, Gg, Gg, Hh, Hh, Hh, Hh, Hh, Hh^Ft, Hh, Hh, Hh, Gg, Gg, Gs, Gg^Es, Gg, Gs, Gs, Gs^Ft, Gs^Ft, Gs^Ft, Gs^Ft, Gs, Ds, Wwt, Wwt, Wot, Wwrt, Wwrt, Wwrt, Wwrt, Wot, Wwrt, Wot, Wot, Wwrt, Wot, Wwrt, Wot, Wot, Wot
Gg, Gg, Gs, Gs, Gg, Gg, Gs, Gg, Gs, Gs, Gs, Gg, Ce, Gg, Gg, Gg, Gs, Gs, Gg, Hh, Hh, Hh, Hh^Ft, Hh^Ft, Hh^Ft, Hh^Ft, Hh^Ft, Hh, Hh, Gg, Gs, Gs, Gs, Gg, Gs, Gs^Ft, Gs^Ft, Gs^Ft, Gs^Ft, Gs, Gs, Ds, Ds, Wwt, Wwt, Wot, Wot, Wot, Wot, Wot, Wot, Wot, Wot, Wot, Wot, Wot, Wwrt, Wot
Gg, Gg, Gs, Gs, Gg, Re^Vct, Gg^Es, Gs, Gs, Gs, Gg, Ce, 1 Ke, Ce, Gg, Gg, Gg, Gs, Gg, Hh, Hh, Hh^Ft, Hh^Ft, Hh^Ft, Hh^Ft, Hh^Ft, Hh^Ft, Hh, Hh, Gg, Gg, Gg, Gg, Gg, Gg, Gs, Gs^Ft, Gs^Ft, Gs^Ft, Gs^Ft, Gs^Ft, Gs, Gg, Ds, Wwt, Wwt, Wot, Wot, Wot, Wot, Wot, Wot, Wot, Wot, Wot, Wot, Wot, Wot
Gg, Gs, Gs, Gg, Gs, Gg, Gg, Gg, Gg, Gg, Gg, Ce, Ce, Ce, Gg, Re^Vct, Gg, Gs, Gg, Gg, Hh, Hh^Ft, Hh^Ft, Hh^Ft, Hh^Ft, Hh^Ft, Hh, Hh, Hh, Gg, Gg, Gg^Es, Gs, Gg, Gs, Gs, Gs^Ft, Gs^Ft, Gs^Ft, Gs^Ft, Gs^Ft, Gs, Gs, Ds, Ds, Wwt, Wwt, Wwt, Wwt, Wwt, Wwt, Wot, Wot, Wot, Wot, Wot, Wot, Wot
Gg, Gg, Gg, Gs, Gg, Gs, Gs, Gs, Gg, Gs, Gg, Ce, Ce, Ce, Gg, Gg, Gg, Gs, Gs, Gg, Hh, Hh^Ft, Hh^Ft, Hh^Ft, Hh^Ft, Hh^Ft, Hh, Hh, Gg, Gg, Gg, Gg, Gg, Gg, Gs, Gs, Gs^Ft, Gs^Ft, Gs^Ft, Gs^Ft, Gs^Ft, Gs^Ft, Gs, Gs, Gg, Ds, Ds, Wwt, Ds, Wwt, Wot, Wot, Wot, Wot, Wot, Wot, Wot, Wwrt
Gs, Gs, Gs, Gg, Gg, Gs, Gs, Gg, Re^Vct, Gg, Gg, Gg, Gg, Gg, Gg^Es, Gg, Gg, Gg, Gg, Hh, Hh, Hh, Hh, Hh^Ft, Hh, Hh, Gg, Gg, Gs, Gg, Gg, Gg, Gg, Gg, Gs, Gs^Ft, Gs^Ft, Gs^Ft, Gs^Ft, Gs^Ft, Gs^Ft, Gs^Ft, Gs^Ft, Gs, Gs, Gg, Gg, Ds, Ds, Wwt, Wwt, Wot, Wot, Wot, Wot, Wot, Wot, Wwrt
Gs^Ft, Gs^Ft, Gs^Ft, Gs, Gs, Gs, Gs, Gg, Gg^Es, Gg, Gs, Gs, Gs, Gg, Gg, Re^Vct, Gg, Gg, Gs, Gg, Gg, Hh^Vhh, Gg, Hh, Gg, Gg, Gg, Gs, Gg, Gs, Gg, Gs, Gs, Gg, Gs, Gs^Ft, Gs^Ft, Gs^Ft, Gs^Ft, Gs^Ft, Gs^Ft, Gs^Ft, Gs^Ft, Gs, Gg, Gg, Gs, Gg, Ds, Wwt, Wwt, Wot, Wwt, Wot, Wot, Wot, Wot, Wot
Gs^Ft, Gs^Ft, Gs^Ft, Gs^Ft, Gs, Gs, Gg, Gg, Gs, Gs, Gg, Gg, Gg, Gs, Gs, Gg, Gg, Gg, Gg, Gg, Gg, Gg, Gs, Gg, Gg, Gg, Gs, Gs, Gg, Gg, Gg, Gg^Es, Gg, Gg, Gg, Gs, Gs, Gs^Ft, Gs^Ft, Gs^Ft, Gs, Gs^Ft, Gs, Gs, Gg, Gd^Vo, Gg, Gs, Gs, Ds, Ds, Wwt, Ds, Wwt, Wwt, Wot, Wot, Wot
Gs^Ft, Gs^Ft, Gs^Ft, Gs^Ft, Gs, Gs, Gs, Gs, Gg, Gg, Gg, Re^Vct, Gg, Gg, Gs, Gs, Gs, Gs, Gs, Gs, Gs, Gg, Gg, Gs, Gg, Gg, Gs, Gg, Hh, Hh, Hh, Gg, Gg, Gs, Gs, Gg, Gg, Gs, Gs, Gs, Gg, Gs, Gg, Gs, Gs, Gg, Gs, Gs, Gg, Gg, Gs, Ds, Ds, Ds, Wwt, Wwt, Wwt, Wwt
Gs^Ft, Gs^Ft, Gs^Ft, Gs^Ft, Gs, Gg, Gg, Gg, Gs, Gg, Gs, Gg, Gs, Gs, Gs, Gs, Gg, Gg, Gg, Gg, Gg, Gg, Gg, Gs, Gg, Gs, Gg, Gg, Hh, Hh^Ft, Hh, Hh, Hh, Gg, Gs, Gg, Gg, Gg, Gd^Vo, Gg, Gs, Gs, Gg, Gg, Gg, Gs, Gg, Gg, Gg, Gg, Gs, Gg, Gs, Ds, Ds, Wwt, Wwt, Wwt
Gs^Ft, Gs^Ft, Gs^Ft, Gs^Ft, Gs, Gs, Gg, Gs, Gg, Gs, Gg, Gs, Gg, Gg, Hh, Gg, Hh, Hh, Gg, Gg, Gg, Gg, Gg, Gs, Gs, Gg, Gg, Gg, Gg, Hh, Gg, Hh^Vhh, Gg, Gg, Gg, Gs, Gg, Gg, Gg, Gg, Gs, Gg, Ko, Gg, Ko, Gg, Ko, Ko, Ko, Gg, Gg, Gs, Gg, Gs, Gg, Ds, Ds, Ds
Gs^Ft, Gs^Ft, Gs^Ft, Gs^Ft, Gs, Gs, Gs, Gg, Gg, Gs, Gg, Gg, Hh, Hh, Hh, Hh, Hh, Hh, Hh, Hh, Hh^Vhh, Gg, Gg, Gg, Gg, Gg, Gs, Gg, Gg, Gg^Es, Gg, Gg, Gg, Gg, Gg, Gg, Gg, Gg^Es, Gg, Gg, Gg, Gg, Urb, Urb, Urb, Ko, Urb, Urb, Urb, Ko, Ko, Gg, Gg, Gg, Gd^Vo, Gs, Gg, Gg
Gs^Ft, Gs^Ft, Gs^Ft, Gs^Ft, Gs, Gg, Gg, Gs, Gs, Gg, Gg, Gg, Hh, Hh, Hh^Ft, Hh, Hh^Ft, Hh, Hh, Hh, Gg, Gg, Gs, Gs, Gg, Gs, Gg, Gg, Gg, Gg, Gs, Gg, Gs, Gs, Gs, Gg, Gg, Gs, Gg, Ko, Gg, Ko, Urb, Urb^Vud, Urb, Urb, Ko, Urb, Urb, Urb, Urb, Ko, Gg, Gg, Gg^Es, Gg, Gs, Gs
Gs^Ft, Gs^Ft, Gs, Gs, Gs, Gg, Gs, Gg, Gs, Gg, Hh^Vhh, Hh, Hh^Ft, Hh^Ft, Hh^Ft, Hh^Ft, Hh^Ft, Hh^Ft, Hh, Gg, Gg, Gg, Gs, Gs, Gg, Gg, Gd^Vo, Gg, Gg, Gg, Gs, Gg, Gs, Gg, Gg, Gs, Gs, Gg, Ko, Gg, Ko, Ko, Urb, Urb, Ko, Ko, Ko, Ko, Ko, Urb, Urb, Ko, Gg, Gg, Gg, Gg^Es, Gs, Gg
Gs, Gs, Gg, Gs, Gg, Gg, Gg, Gg, Gg, Hh, Hh, Hh, Hh^Ft, Hh^Ft, Hh^Ft, Hh^Vhh, Hh^Ft, Hh^Ft, Hh, Gg, Gg, Gg, Gg, Gs, Gg, Gg, Gg, Gg, Gg, Gg, Gs, Gg, Gg, Gg, Gg, Gg, Urb, Urb, Urb, Ko, Urb, Urb, Urb, Urb, Ko, Ko, 2 Kud, Ko, Ko, Urb, Urb^Vud, Urb, Ko, Gg, Gg, Gs, Gg^Es, Gg
Gs, Gg, Gg, Gs, Gg, Gg, Gg, Gg, Gg, Hh, Gg, Hh, Hh^Ft, Hh^Ft, Hh^Ft, Hh^Ft, Hh, Hh, Hh, Gg, Gg, Gg, Gg, Gs, Gs, Gg, Gg, Gs, Gs, Gs, Gg, Gg, Gg, Gg, Gg, Ko, Urb, Urb, Urb, Urb, Urb, Urb^Vud, Urb, Urb, Ko, Ko, Ko, Ko, Ko, Urb, Urb, Urb, Gg, Gg, Gg, Gs, Gg, Gg
Gg, Gg, Gg, Gg, Gs, Gg, Gs, Gs, Gg, Gg, Gg, Hh, Hh, Hh^Ft, Hh^Ft, Hh^Ft, Hh, Hh, Hh, Gg, Gs, Gs, Gg, Gs, Gg, Gs, Gg^Es, Gg, Gg, Gg, Gg, Gg, Gg, Ko, Gg, Ko, Urb, Urb^Vud, Urb, Urb, Ko, Urb, Urb, Urb, Urb, Ko, Ko, Ko, Urb, Urb, Urb, Ko, Gg, Gg, Gd^Vo, Gg, Gs, Gs
Gg, Gg, Gs, Gg, Gg, Gs, Gg, Gg, Gg, Gg, Gg, Gg, Hh, Hh, Hh, Hh, Hh, Hh, Gg, Gg, Gg, Gg, Gs, Gg, Gg, Gg, Gg, Gg, Gg, Gg, Gs, Gg, Gg, Gg, Ko, Ko, Urb, Urb, Ko, Ko, Ko, Ko, Ko, Urb, Urb, Urb, Urb, Urb, Urb, Urb, Ko, Ko, Gg, Gg, Gs, Gs, Gs^Ft, Gs^Ft
Gg, Gg, Gg, Gg, Gg, Gs, Gg, Gg, Gg, Gg^Efm, Gg^Efm, Gg, Gg, Hh, Hh, Gg, Gg, Gg, Gs, Gs, Gs, Gs, Gs^Ft, Gs, Gs, Gg, Gd^Vo, Gg, Gg, Gs, Gg, Gg, Urb, Urb, Urb, Urb, Urb^Vud, Urb, Ko, Ko, 3 Kud, Ko, Ko, Urb, Urb, Urb^Vud, Urb, Urb, Ko, Ko, Gg, Gg, Gg, Gs, Gs, Gs^Ft, Gs^Ft, Gs^Ft
Gg, Gs, Gs, Gs, Gg, Gg, Gg^Efm, 5 Gg^Efm, Gg^Efm, Gg^Efm, Gg^Efm, Gg^Efm, Gg^Efm, Gg, Gg, Gg, Gs, Gs, Gg, Gg, Gs, Gs^Ft, Gs^Ft, Gs^Ft, Gs^Ft, Gs, Gg, Gg, Gs, Gs, Ko, Ko, Urb, Urb, Urb^Vud, Urb, Urb, Urb, Ko, Ko, Ko, Ko, Ko, Urb, Urb^Vud, Urb, Urb, Urb, Ko, Gg, Gs, Gs, Gg, Gg, Gs, Gs^Ft, Gs^Ft, Gs^Ft
Gg, Gg, Gg, Gg, Gg, Gg, Gg^Efm, Gg^Efm, Gg^Efm, Gg^Efm, Gg^Efm, Gg, Gg^Efm, Gg^Efm, Gg, Gg, Gg, Gg, Gs, Gg, Gs, Gs^Ft, Gs^Ft, Gs^Ft, Gs^Ft, Gs, Gg, Gg, Gs, Gg, Ko, Urb, Urb^Vud, Urb, Urb, Urb, Urb, Urb, Urb, Ko, Ko, Ko, Urb, Urb, Urb, Urb, Ko, Ko, Gg, Gg, Gs, Gg, Gg, Gs, Gs, Gs^Ft, Gs^Ft, Gs^Ft
Gg, Gs, Gg, Gs, Gg, Gg^Efm, Gg, Gg^Efm, Gg, Gg, Gg^Efm, Gg^Efm, Gg^Efm, Gg^Efm, Gg^Efm, Gg, Gg, Gd^Vo, Gg, Gs, Gs^Ft, Gs^Ft, Gs^Ft, Gs^Ft, Gll, Gs, Gs, Gg, Gg^Es, Gg, Ko, Urb, Urb, Urb, Ko, Ko, Ko, Urb, Urb, Urb, Urb, Urb, Urb, Urb^Vud, Urb, Urb, Ko, Gg, Gg, Gs, Gg, Gd^Vo, Gg, Gg, Gll, Gs^Ft, Gs^Ft, Gs^Ft
Gg, Gg, Gg, Gg, Gg^Efm, Gg^Efm, Gg^Efm, Gg^Efm, Gg, Gg^Efm, Gg^Efm, Gg, Gg^Efm, Gg^Efm, Gg, Gg^Efm, Gg^Efm, Gg, Gs, Gs, Gs^Ft, Gs^Ft, Gs^Ft, Gs^Ft, Gll, Gg, Gg, Gg, Gg, Gg, Urb, Urb, Urb, Ko, Ko, Ko, Ko, Ko, Urb, Urb, Urb^Vud, Urb, Urb, Urb, Urb, Ko, Gg, Gg, Gg, Gs, Gg, Gg, Gs, Gs, Gs^Ft, Gll, Gll, Gll
Gg, Gs, Gg, Gg, Gg^Efm, Gg, Gg^Efm, Gg^Efm, Gg, Gd^Vo, Gg^Efm, Gg^Efm, Gg^Efm, Gg, Gg^Efm, Gg^Efm, Gg^Efm, Gg, Gs, Gs, Gs^Ft, Gs^Ft, Gs^Ft, Gll, Gs, Gd^Vo, Gg, Gg, Gg, Ko, Urb, Urb^Vud, Urb, Ko, Ko, 4 Kud, Ko, Ko, Urb, Urb, Urb, Urb, Ko, Urb, Ko, Gg, Gs, Gs, Gg, Gs, Gs, Gs, Gs^Ft, Gs^Ft, Gs^Ft, Gs^Ft, Gs^Ft, Gg
Gg, Gs, Gg, Gg, Gg, Gg^Efm, Gg^Efm, Gg, Gg, Gg^Efm, Gg, Gg^Efm, Gg^Efm, Gg^Efm, Gg, Gg^Efm, Gg, Gg, Gg, Gs, Gs^Ft, Gs^Ft, Gs^Ft, Gs^Ft, Gs, Gg, Gg, Gg, Gg, Gg, Ko, Urb, Urb, Ko, Ko, Ko, Ko, Ko, Urb, Urb, Urb, Ko, Gg, Gg, Gg, Gs, Gs, Gg, Gg, Gs, Gs^Ft, Gs^Ft, Gs^Ft, Gs^Ft, Gs^Ft, Gs^Ft, Gs^Ft, Gg
Gg, Gs, Gg, Gg, Gg^Efm, Gg^Efm, Gg^Efm, Gg, Gg^Efm, Gg, Gg^Efm, Gg^Efm, Gg^Efm, Gg^Efm, Gg^Efm, Gg^Efm, Gg, Gg, Gg, Gs, Gs^Ft, Gs^Ft, Gs^Ft, Gs^Ft, Gs^Ft, Gs, Gs, Gg, Gg, Gg, Ko, Urb, Urb, Urb, Urb, Ko, Urb, Urb, Urb, Urb, Ko, Ko, Gg, Gg, Gs, Gs, Gg, Gg^Es, Gd^Vo, Gs, Gs^Ft, Gs^Ft, Gs^Ft, Gs^Ft, Gs^Ft, Gs^Ft, Gs^Ft, Gg
Gg, Gg, Gg, Gg, Gg^Efm, Gg, Gg, Gg^Efm, Gg^Efm, Gg^Efm, Gg^Efm, Gg^Efm, Gg, Gg, Gs, Gg, Gs, Gg, Gg, Gs, Gs, Gs^Ft, Gs^Ft, Gs^Ft, Gs^Ft, Gs^Ft, Gs, Gg, Gg^Es, Gg, Gg, Ko, Ko, Urb, Urb, Urb, Urb, Urb^Vud, Urb, Ko, Gg, Gg, Gs, Gs, Gs^Ft, Gs, Gs, Gg, Gg, Gs, Gs, Gs^Ft, Gs^Ft, Gs^Ft, Gs^Ft, Gs^Ft, Gs^Ft, Gs^Ft
Gg, Gs, Gs, Gg, Gg, Gg^Efm, Gg^Efm, Gg^Efm, Gg, Gg, Gg, Gg, Gs, Gs, Gg, Gs, Gs, Gg, Gs, Gg, Gg, Gs, Gs^Ft, Gs^Ft, Gs^Ft, Gs^Ft, Gs, Gg, Gs, Gg, Gs, Gg, Gg, Ko, Ko, Urb, Ko, Urb, Ko, Gg, Gs, Gs, Gs^Ft, Gs^Ft, Gs^Ft, Gs^Ft, Gs^Ft, Gs, Gs, Gs, Gs, Gs^Ft, Gs^Ft, Gs^Ft, Gs^Ft, Gs^Ft, Gs^Ft, Gs^Ft
Ds, Ds, Ds, Ds, Ds, Gg, Ds, Gg, Gs, Gg, Gs, Gs, Gg, Gg, Gg, Gg, Gg, Gs, Gg, Gs, Gs, Gs, Gs, Gll, Gs, Gll, Gll, Gll, Gs^Ft, Gll, Gs^Ft, Gs, Gs, Gg, Gg, Ko, Gg, Gg, Gg, Gs, Gs, Gs, Gs^Ft, Gs^Ft, Gs^Ft, Gs^Ft, Gs^Ft, Gs, Gll, Gs, Gg, Gll, Gs^Ft, Gs^Ft, Gs^Ft, Gs^Ft, Gs^Ft, Gs^Ft
Wwt, Wwt, Wwt, Wwt, Wwt, Ds, Wwt, Ds, Ds, Gs, Ds, Ds, Ds, Ds, Ds, Gg, Ds, Gg, Ds, Gs, Gs, Gs, Gs, Gs, Gg, Gg, Gs, Gs^Ft, Gs^Ft, Gs^Ft, Gs^Ft, Gs^Ft, Gs^Ft, Gs, Gs, Gg, Gs, Gs, Gs, Gs, Gs, Gs, Gs^Ft, Gs^Ft, Gs^Ft, Gs^Ft, Gs^Ft, Gs^Ft, Gs^Ft, Gs, Gll, Gll, Gll, Gs^Ft, Gll, Gs, Gs, Gll
Wot, Wwt, Wot, Wwt, Wwt, Wwt, Wwt, Wwt, Wwt, Ds, Wwt, Wwt, Wwt, Wwt, Wwt, Ds, Wwt, Ds, Wwt, Ds, Ds, Gg, Gg, Gs, Gs, Gs, Gs, Gs^Ft, Gs^Ft, Gs^Ft, Gs^Ft, Gs^Ft, Gs^Ft, Gs^Ft, Gs, Gs, Gg, Gd^Vo, Gg, Gs, Gs, Gs^Ft, Gs^Ft, Gs^Ft, Gs^Ft, Gs^Ft, Gs^Ft, Gs^Ft, Gs^Ft, Gs^Ft, Gs^Ft, Gs, Gs, Gll, Gll, Gll, Gg, Gs
Wot, Wot, Wot, Wot, Wwt, Wwt, Wot, Wwt, Wot, Wwt, Wwt, Wwt, Wot, Wwt, Wot, Wwt, Wwt, Wwt, Wwt, Wwt, Wwt, Ds, Ds, Gs, Gs, Gg, Gg, Gs, Gs, Gs^Ft, Gs, Gs^Ft, Gs^Ft, Gs^Ft, Gs, Gs, Gg, Gg, Gg^Es, Gs, Gs, Gs^Ft, Gs^Ft, Gs^Ft, Gs^Ft, Gs^Ft, Gs^Ft, Gs^Ft, Gs^Ft, Gs^Ft, Gs^Ft, Gs^Ft, Gs^Ft, Gs, Gs, Gs, Gs, Gg
Wot, Wot, Wot, Wot, Wot, Wot, Wot, Wot, Wot, Wot, Wot, Wot, Wot, Wot, Wot, Wot, Wot, Wot, Wot, Wwt, Wwt, Ds, Ds, Ds, Ds, Ds, Ds, Gg, Gs, Gs, Gg, Gs, Gs, Gs, Gs, Gs, Gs, Gg, Gg, Gs, Gs, Gs, Gs, Gs, Gg, Gs, Gs, Gs^Ft, Gs^Ft, Gs^Ft, Gs^Ft, Gs^Ft, Gs^Ft, Gs^Ft, Gs^Ft, Gs^Ft, Gs^Ft, Gs
Wot, Wot, Wot, Wot, Wot, Wot, Wot, Wot, Wot, Wot, Wot, Wot, Wot, Wot, Wot, Wot, Wot, Wot, Wot, Wwt, Wwt, Wwt, Wwt, Ds, Wwt, Ds, Wwt, Ds, Ds, Gs, Gs, Gs, Gg, Gg, Gg, Gg, Gs, Gs, Gs, Gs, Gg, Gs, Gs, Gs, Gs, Gg, Gs, Gs, Gs, Gs^Ft, Gll, Gs^Ft, Gs^Ft, Gs^Ft, Gs^Ft, Gs^Ft, Gs^Ft, Gs^Ft
Wot, Wot, Wot, Wot, Wot, Wot, Wot, Wot, Wot, Wot, Wot, Wot, Wot, Wot, Wot, Wot, Wot, Wot, Wot, Wot, Wot, Wwt, Wwt, Wwt, Wwt, Wwt, Wwt, Wwt, Wwt, Ds, Ds, Gg, Ds, Ds, Ds, Ds, Ds, Ds, Ds, Ds, Ds, Ds, Ds, Gg, Gg, Gs, Gs, Gg, Gs, Gs, Gs, Gs^Ft, Gs^Ft, Gs^Ft, Gs^Ft, Gs^Ft, Gs^Ft, Gs^Ft
Wot, Wot, Wot, Wot, Wot, Wot, Wot, Wot, Wot, Wot, Wot, Wot, Wot, Wot, Wot, Wot, Wot, Wot, Wot, Wot, Wot, Wot, Wot, Wot, Wot, Wot, Wot, Wwt, Wwt, Wwt, Wwt, Ds, Wwt, Wwt, Wwt, Wwt, Wwt, Wwt, Wwt, Wwt, Wwt, Wwt, Wwt, Ds, Ds, Gg, Gg, Gg, Gs, Gg, Gs, Gs^Ft, Gs^Ft, Gs^Ft, Gs^Ft, Gs^Ft, Gs^Ft, Gs^Ft
Wot, Wot, Wot, Wot, Wot, Wot, Wot, Wot, Wot, Wot, Wot, Wot, Wot, Wot, Wot, Wot, Wot, Wot, Wot, Wot, Wot, Wot, Wot, Wot, Wot, Wot, Wot, Wot, Wot, Wwt, Wwt, Wwt, Wot, Wwt, Wot, Wwt, Wwt, Wwt, Wot, Wwt, Wot, Wwt, Wwt, Wwt, Wwt, Ds, Gg, Gg, Gs, Gg, Gs, Gs^Ft, Gs^Ft, Gs^Ft, Gs^Ft, Gs^Ft, Gs^Ft, Gs^Ft
Wot, Wot, Wot, Wot, Wot, Wot, Wot, Wot, Wot, Wot, Wot, Wot, Wot, Wot, Wot, Wot, Wot, Wot, Wot, Wot, Wot, Wot, Wot, Wot, Wot, Wot, Wot, Wot, Wot, Wot, Wot, Wot, Wot, Wot, Wot, Wot, Wot, Wot, Wot, Wot, Wot, Wot, Wot, Wwt, Wwt, Ds, Gg, Gg, Gs, Gg, Gg, Gs, Gg, Gs^Ft, Gs^Ft, Gs^Ft, Gs^Ft, Gs^Ft
