Gg, Gg, Gs^Ft, Gs^Ft, Gs^Ft, Gs^Ft, Gs, Gg, Gg, Gg, Gg, Gg, Gg, Gg, Gg, Gg, Ds, Ds, Ds, Wwt, Wwt, Wot, Wwt, Wot, Wwt, Wot, Wwt, Wwt, Wwt, Wot, Wwt, Wot, Wot, Wot, Wot, Wot, Wot, Wot, Wot, Wot, Wot, Wot, Wot, Wot, Wot, Wot, Wot, Wot, Wot, Wot, Wot, Wot, Wot, Wot, Wot, Wot, Wot, Wot, Wot, Wot, Wot, Wot
Gs^Ft, Gs^Ft, Gs^Ft, Gs^Ft, Gs^Ft, Gs^Ft, Gs, Gg, Gg, Re^Vct, Gg, Gg, Gg, Gg, Gs, Gg, Gg, Ds, Ds, Wwt, Ds, Wwt, Wwt, Wwt, Wwt, Wwt, Wwt, Wwt, Wwt, Wwt, Wwt, Wwt, Wwt, Wot, Wot, Wot, Wot, Wot, Wot, Wot, Wot, Wot, Wot, Wot, Wot, Wot, Wot, Wot, Wot, Wot, Wot, Wot, Wot, Wot, Wot, Wot, Wot, Wot, Wot, Wot, Wot, Wot
Gs^Ft, Gs^Ft, Gs^Ft, Gs^Ft, Gs^Ft, Gs, Gs, Gs, Gs, Gs, Gs, Gs, Gs, Gs, Gg, Gs, Gs, Gg, Gg, Ds, Ds, Ds, Ds, Ds, Ds, Wwt, Wwt, Wwt, Wwt, Wwt, Ds, Wwt, Wwt, Wwt, Wwt, Wot, Wot, Wot, Wot, Wot, Wot, Wot, Wwrt, Wot, Wot, Wot, Wot, Wot, Wot, Wot, Wot, Wot, Wot, Wot, Wot, Wot, Wot, Wot, Wot, Wot, Wot, Wot
Gs^Ft, Gs^Ft, Gs^Ft, Gs^Ft, Gs, Gs, Re^Vct, Gg, Gg, Gg, Ce, Gg, Gs, Gg, Re^Vct, Gg, Gs, Gg, Gs, Gg, Gg, Gg, Gg, Ds, Gs, Ds, Gs^Ft, Gs^Ft, Gs^Ft, Ds, Ds, Ds, Ds, Wwt, Wwt, Wot, Wot, Wot, Wot, Wot, Wot, Wot, Wot, Wwrt, Wwrt, Wot, Wot, Wot, Wot, Wot, Wot, Wot, Wot, Wot, Wot, Wot, Wot, Wot, Wot, Wot, Wot, Wot
Gs^Ft, Gs^Ft, Gs^Ft, Gs, Gs, Gg, Gg, Gg, Gg, Ce, 2 Ke, Ce, Gg, Gs, Gg, Gg, Gg, Gg, Gs, Gg, Gs, Gg, Gs, Gg, Gs, Gs^Ft, Gs^Ft, Gs^Ft, Hd, Hd, Hd, Hd, Ds, Wwt, Wwt, Wwt, Wot, Wot, Wot, Wot, Wot, Wot, Wot, Wot, Wot, Wot, Wwrt, Wot, Wot, Wot, Wot, Wot, Wot, Wot, Wot, Wot, Wot, Wot, Wot, Wot, Wot, Wot
Gs^Ft, Gs^Ft, Gs, Gs, Gs, Gg, Gs, Gg, Gg, Ce, Ce, Ce, Gg, Gs, Gs, Gs, Gg, Gg, Gg, Gg, Gg, Gs, Gg, Gs, Gs^Ft, Gs^Ft, Gs^Ft, Gs^Ft, Hd, Hd, Hd, Hd, Ds, Ds, Wwt, Wwt, Wwt, Wot, Wot, Wot, Wot, Wot, Wot, Wot, Wot, Wot, Wot, Wot, Wot, Wot, Wot, Wot, Wot, Wot, Wot, Wot, Wot, Wot, Wot, Wot, Wot, Wot
Gs^Ft, Gs^Ft, Gg, Gg, Gg, Gg, Gg, Gg, Gg, Gg, Gg, Gg, Gg, Gs, Gs, Gg, Gg, Re^Vct, Gg, Gg, Gs, Gg, Gg, Gs, Gs, Gs^Ft, Gs^Ft, Gs^Ft, Gs^Ft, Hd, Hd, Hd, Hd, Gs^Ft, Gs^Ft, Wwt, Wwt, Wwt, Wwt, Wot, Wot, Wot, Wot, Wot, Wot, Wot, Wot, Wwrt, Wot, Wot, Wot, Wot, Wot, Wot, Wot, Wot, Wot, Wot, Wot, Wot, Wot, Wot
Gs^Ft, Gs^Ft, Gs, Gg, Gs, Gg, Gs, Gs, Re^Vct, Gg, Gg, Gs, Gg, Gg, Gg, Gg, Gg, Gg, Gg, Gg, Gs, Gg, Gg, Gg, Gs, Gs^Ft, Gs^Ft, Gs^Ft, Gs^Ft, Gs^Ft, Gs^Ft, Gs^Ft, Gs^Ft, Gs^Ft, Gs^Ft, Ds, Ds, Wwt, Wwt, Wot, Wot, Wot, Wot, Wot, Wot, Wot, Wot, Wot, Wwrt, Wot, Wot, Wot, Wot, Wot, Wot, Wot, Wot, Wot, Wot, Wot, Wot, Wot
Gs^Ft, Gs^Ft, Gs, Gg, Gg, Gs, Gs, Gg, Gg, Gg, Gg, Gs, Gg, Re^Vct, Gg, Gs, Gg, Gs, Gs, Gs, Gs, Gg, Gg, Gg, Gg, Gs, Gs, Gs^Ft, Gs^Ft, Gs^Ft, Gs^Ft, Gs^Ft, Gs^Ft, Gs^Ft, Gs^Ft, Gs^Ft, Ds, Wwt, Wwt, Wot, Wot, Wot, Wot, Wot, Wot, Wot, Wot, Wot, Wot, Wot, Wot, Wot, Wot, Wot, Wot, Wot, Wot, Wot, Wot, Wot, Wot, Wot
Gs^Ft, Gs^Ft, Gs^Ft, Gs, Gs, Gg, Gs, Gs, Gs, Gg, Gs, Gg, Gg, Gg, Gg, Gg, Gg, Gs, Gg, Gg, Gg, Gg, Gs, Gg, Gg, Gg, Gs, Gs, Gs, Gs, Gs, Gs, Gs, Gs^Ft, Gs^Ft, Gs^Ft, Ds, Wwt, Wwt, Wwt, Wot, Wot, Wot, Wot, Wot, Wot, Wot, Wot, Wot, Wot, Wwrt, Wot, Wot, Wot, Wot, Wot, Wot, Wot, Wot, Wot, Wot, Wot
Gs^Ft, Gs^Ft, Gs^Ft, Gs^Ft, Gs^Ft, Gs, Gs, Gs, Gs, Gs, Gs, Gg, Gs, Gg, Gs, Gg, Gs, Gs, Gg, Gg, Gs, Gg, Gg, Gg, Gg, Gg, Gs, Gg, Gg, Gg, Gg, Gg, Gg, Gs, Gs, Gs, Gs, Ds, Wwt, Wwt, Wwt, Wot, Wot, Wot, Wot, Wot, Wot, Wot, Wot, Wot, Wwrt, Wot, Wot, Wot, Wot, Wot, Wot, Wot, Wot, Wot, Wot, Wot
Gs^Ft, Gs^Ft, Gs^Ft, Gs^Ft, Gs^Ft, Gs^Ft, Gs^Ft, Gs, Gs, Gs, Gg, Gg, Gg, Gg, Gg, Gs, Gg, Gg, Gs, Gs, Hh, Gs, Gs, Gs, Gg, Gs, Gg, Gg, Gg, Gg, Gg, Gg, Gg, Gg, Gg, Gs, Gs, Ds, Wwt, Wwt, Wwt, Wwt, Wwt, Wot, Wot, Wot, Wot, Wot, Wot, Wot, Wot, Wot, Wot, Wot, Wot, Wot, Wot, Wot, Wot, Wot, Wot, Wot
Gs^Ft, Gs^Ft, Gs^Ft, Gs^Ft, Gs^Ft, Gs^Ft, Gs^Ft, Gs^Ft, Gs^Ft, Gs, Gs, Gg, Gg, Gg, Gg, Gs, Gg, Gs, Hh, Hh, Hh, Hh, Hh, Gs, Gs, Gg, Gg, Gg, Gg, Gg^Efm, Gg, Gg^Efm, Gg^Efm, Gg^Efm, Gg, Gg, Gs, Ds, Ds, Wwt, Ds, Wwt, Wwt, Wwt, Wot, Wot, Wot, Wot, Wot, Wot, Wot, Wot, Wot, Wot, Wot, Wot, Wot, Wot, Wot, Wot, Wot, Wot
Gs^Ft, Gs^Ft, Gs^Ft, Gs^Ft, Gs^Ft, Gs^Ft, Gs^Ft, Gs^Ft, Gs^Ft, Gs^Ft, Gs, Gg, Gs, Gg, Gs, Gs, Gs, Gs, Hh, Hh, Hh^Ft, Hh, Hh^Ft, Hh, Hh, Gs, Gs, Gg, Gg, Gg^Efm, Gg^Efm, Gg, Gg^Efm, Gg^Efm, Gg^Efm, Gg, Gg, Gs, Gs, Ds, Gs, Ds, Wwt, Wwt, Wwt, Wwt, Wwt, Wot, Wot, Wot, Wot, Wot, Wot, Wot, Wot, Wot, Wot, Wwrt, Wwrt, Wot, Wot, Wot
Gs^Ft, Gs^Ft, Gs^Ft, Gs^Ft, Gs^Ft, Gs^Ft, Gs^Ft, Gs^Ft, Gs^Ft, Gs^Ft, Gs, Gs, Gs, Gg, Gg, Gs, Hh, Hh, Hh^Ft, Hh^Ft, Hh^Ft, Hh^Ft, Hh^Ft, Hh^Ft, Hh^Ft, Hh, Gs, Gg, Gg, Gg, Gg^Efm, Gg^Efm, Gg^Efm, Gg^Efm, Gg, Gg^Efm, Gg, Gg, Gg, Gs, Gs, Ds, Ds, Wwt, Wwt, Wwt, Wwt, Wwt, Wwt, Wot, Wot, Wot, Wot, Wot, Wot, Wot, Wot, Wot, Wwrt, Wot, Wot, Wot
Gs^Ft, Gs^Ft, Gs^Ft, Gs^Ft, Gs^Ft, Gs^Ft, Gs^Ft, Gs^Ft, Gs^Ft, Gs^Ft, Gs, Gg, Gg, Gs, Gs, Gs, Hh, Hh^Ft, Hh^Ft, Hh^Ft, Hh^Ft, Hh^Ft, Hh^Ft, Hh^Ft, Hh^Ft, Hh, Gs, Gg, Gg^Efm, Gg^Efm, Gg^Efm, Gg, Gg^Efm, Gg^Efm, Gg^Efm, Gg^Efm, Gg, Gg, Gs, Gg, Gg, Gs, Gs, Ds, Ds, Ds, Ds, Wwt, Wwt, Wwt, Wwt, Wot, Wot, Wot, Wot, Wot, Wot, Wot, Wot, Wot, Wot, Wot
Gs^Ft, Gs^Ft, Gs^Ft, Gs^Ft, Gs^Ft, Gs^Ft, Gs^Ft, Gs^Ft, Gs, Gs, Gg, Gg, Gs, Gs, Gs, Hh, Hh, Hh^Ft, Hh^Ft, Hh^Ft, Hh^Ft, Hh^Ft, Hh^Ft, Hh^Ft, Hh^Ft, Hh, Hh, Gs, Gg, Gg^Efm, Gg^Efm, Gg^Efm, Gg, Gg^Efm, Gg, Gg, Gg, Gg, Gg, Gg, Gg, Gg, Gs, Ds, Ds, Ds, Ds, Ds, Wwt, Wwt, Wwt, Wot, Wot, Wot, Wot, Wot, Wot, Wot, Wot, Wwrt, Wot, Wot
Gs^Ft, Gs^Ft, Gs^Ft, Gs^Ft, Gs^Ft, Gs^Ft, Gs, Gs, Gs, Gs, Gs, Gg, Gg, Gg, Gs, Hh, Hh, Hh^Ft, Hh^Ft, Hh^Ft, Hh^Ft, Hh^Ft, Hh^Ft, Hh^Ft, Hh^Ft, Hh^Ft, Hh, Gs, Gg, Gg, Gg, Gg, Gg, Gg, Gg, Gg, Gs, Gs, Gg, Gg, Gg, Gg, Gg, Gs, Gs, Gs, Ds, Ds, Ds, Wwt, Wwt, Wwt, Wot, Wot, Wot, Wot, Wot, Wot, Wot, Wwrt, Wwrt, Wot
Gs^Ft, Gs^Ft, Gs, Gs, Gs, Gs, Gg, Gg, Gs, Gg, Gs, Gs, Gs, Gs, Gg, Gs, Hh, Hh, Hh, Hh^Ft, Hh^Ft, Hh^Ft, Hh^Ft, Hh^Ft, Hh, Hh, Hh, Gs, Gg, Gs, Gg, Gg, Gg, Gg, Gs, Gg, Gg, Gs, Gg, Gg, Gg, Gg, Gg, Gg, Gg, Gs, Gs, Ds, Ds, Wwt, Wwt, Wwt, Wwt, Wot, Wot, Wot, Wot, Wot, Wot, Wot, Wot, Wot
Gs, Gs, Gs, Gs, Gg, Gs, Gg, Gg, Re^Vct, Gg, Gg, Gg, Gg, Gs, Gg, Gs, Gs, Hh, Hh, Hh, Hh, Hh^Ft, Hh, Hh^Ft, Hh, Hh, Gs, Gs, Gs, Gg, Gg, Gs, Gg, Gg, Gg, Gg, Re^Gvs, Gg, Gg, Gs, Gg, Gg, Gs^Vh, Gg, Gs, Gg, Gg, Gs, Gs, Ds, Wwt, Wwt, Wwt, Wot, Wot, Wot, Wot, Wot, Wot, Wot, Wot, Wot
Gs, Gs, Gg, Re^Vct, Gs, Gs, Gg, Gg, Gg, Gg, Gg, Gg, Gs, Gg, Gg, Gs, Gg, Gs, Gs, Hh, Hh, Hh, Hh, Hh, Hh, Hh, Gs, Gs, Gg, Gs, Gs, Gg, Gg, Gg, Re^Gvs, Re^Gvs, Re^Gvs, Re^Gvs, Re^Gvs, Gg, Gg, Gg, Gg, Gg, Gg, Gg, Gs^Vh, Gg, Gs, Ds, Ds, Wwt, Wwt, Wot, Wot, Wot, Wot, Wot, Wot, Wot, Wot, Wot
Gs, Gg, Gg, Gg, Gg, Gg, Ce, Gg, Gg, Gg, Re^Vct, Gg, Gg, Gs, Gg, Gg, Gg, Gg, Gg, Gs, Gs, Hh, Gs, Hh, Gs, Gs, Gg, Gg, Gs, Gg, Gg, Gg, Gg, Gs, Gs, Re^Gvs, Re^Gvs, Re^Gvs, Gg, Gg, Gg, Gs, Gs, Gs, Gg, Gg, Gg, Gg, Gs, Gs, Ds, Wwt, Wwt, Wwt, Wot, Wot, Wot, Wot, Wot, Wot, Wot, Wot
Gs^Ft, Gs, Gs, Gs, Gg, Ce, 3 Ke, Ce, Gg, Gg, Gg, Gg, Gs, Gg, Gg, Gg, Gs, Gs, Gs, Gg, Gg, Gs, Gs, Gs, Gg, Gg, Gs, Gg, Gg, Gg, Re^Gvs, Re^Gvs, Re^Gvs, Gg, Gg, Gg, Gs^Vh, Gg, Gg, Gg, Gg, Gg, Gg, Gs, Gg, Gg, Gs, Gs, Gg, Gs, Ds, Wwt, Wwt, Wwt, Wot, Wot, Wot, Wot, Wot, Wot, Wot, Wot
Gs^Ft, Gs^Ft, Gs^Ft, Gs, Gg, Ce, Ce, Ce, Gs, Gg, Gs, Gg, Gs, Gg, Gg, Gs, Gs^Ft, Gs^Ft, Gs^Ft, Gs, Gs, Gg, Gg, Gs, Gs, Gs, Gg, Gg, Gg, Re^Gvs, Re^Gvs, Re^Gvs, Re^Gvs, Re^Gvs, Gg, Gg, Gg, Gg, Gg, Gs, Gg, Gg, Gg, Gg, Gg, Gg, Gg, Gg, Gg, Gs, Gs, Ds, Wwt, Wwt, Wwt, Wot, Wot, Wot, Wot, Wot, Wot, Wot
Gs^Ft, Gs^Ft, Gs^Ft, Gs, Gs, Gg, Gg, Gg, Gg, Gg, Gg, Gs, Gs, Gg, Gg, Gs, Gs, Gs^Ft, Gs, Gs, Gg, Gg, Gg, Gs, Gs, Gg, Gg, Gg, Gg, Gs^Vh, Gg, Re^Gvs, Gg, Gg, Gg, Gs, Gs, Gg, Gg, Gg, Gg, Gg, Kd, Rp, Rp, Rp, Kd, Gg, Gg, Gg, Gs, Ds, Ds, Wwt, Wwt, Wwt, Wwt, Wot, Wot, Wot, Wot, Wot
Gs^Ft, Gs^Ft, Gs^Ft, Gs, Gg, Gg, Gs, Gg, Gs, Gg, Re^Vct, Gg, Gs, Gg, Gg, Gg, Gg, Gs, Gg, Gg, Gs, Gs, Gs, Gg, Gg, Gg, Re^Gvs, Re^Gvs, Re^Gvs, Gg, Gg, Gg, Gg, Gg, Gs, Gs, Gg, Gs, Gg, Gg, Cd, Cd, Rp, Rp, Rp, Rp, Rp, Cd, Cd, Gg, Gg, Gs, Gs, Ds, Ds, Wwt, Wwt, Wwt, Wot, Wot, Wot, Wot
Gs, Gs^Ft, Gs, Gs, Re^Vct, Gg, Gs, Gg, Gg, Gg, Gg, Gg, Gs, Gs, Gs, Gg, Gg, Gg, Gs, Gs, Gs, Gg, Gg, Gg, Gg, Re^Gvs, Re^Gvs, Re^Gvs, Re^Gvs, Gs^Vh, Gg, Gg, Gg, Gg, Gg, Gg, Gg, Gg, Cd, Cd, Rp, Rp, Rr^Vda, Rp, Rp, Rp, Rp, Rp, Rp, Cd, Cd, Gg, Gg, Gs, Ds, Wwt, Wwt, Wwt, Wot, Wot, Wot, Wot
Gg, Gs, Gg, Gg, Gg, Gg, Gs, Gg, Gs, Gg, Gg, Gs, Gs^Ft, Gs^Ft, Gs^Ft, Gs, Gg, Gg, Gg, Gg, Gg, Gg, Gg, Gg, Gg, Gg, Gg, Re^Gvs, Gg, Gg, Re^Gvs, Gg, Gs^Vh, Gg, Gg, Gg, Gg, Gg, Cd, Rp, Rp, Rp, Rp, Rp, Kd, Rp, Rp, Rr^Vda, Rp, Rp, Cd, Gg, Gg, Gs, Ds, Wwt, Wwt, Wwt, Wwt, Wot, Wot, Wot
Gs, Gs, Gs, Gg, Gs, Gg, Gg, Gs, Gg, Gg, Gs, Gs, Gs^Ft, Gs^Ft, Gs, Gs, Gg, Gs, Gg, Gg, Gg, Gg, Re^Gvs, Re^Gvs, Re^Gvs, Gg, Gg, Gg, Re^Gvs, Re^Gvs, Re^Gvs, Re^Gvs, Re^Gvs, Gg, Gs, Gg, Gg, Gg, Cd, Rp, Rr^Vda, Rp, Kd, Kd, Cd, Kd, Kd, Rp, Rp, Rp, Kd, Gg, Gg, Gs, Rr, Wwt, Wwt^Bw/, Wwt, Wwt, Wot, Wot, Wot
Gs, Gg, Gg, Gg, Gs, Gs, Gg, Gg, Gs, Gg, Gs, Gs^Ft, Gs^Ft, Gs, Gg, Gg, Gs, Gs, Gg, Gg, Gg, Re^Gvs, Re^Gvs, Re^Gvs, Re^Gvs, Re^Gvs, Gg, Gg, Gg, Re^Gvs, Re^Gvs, Re^Gvs, Gg, Gg, Gg, Gg, Gg, Gg, Kd, Rp, Rp, Rp, Kd, Cd, 1 Kd, Cd, Kd, Rp, Rr^Vda, Rp, Rr, Gg, Gg, Gs, Rr, Ket, Ket, Wwt^Bw/, Wwt, Wot, Wot, Wot
Gs, Gg, Gg, Gg, Gg, Gg, Gs, Gs, Gg, Gg, Gg, Gs, Gs, Gs, Gs, Gs, Gg, Gg, Gg, Gg, Gg, Gg, Gg, Re^Gvs, Gg, Gs^Vh, Gg, Gg, Gg, Gg, Gg, Gg, Gg, Gg, Gg, Gs, Gg, Gg, Rp, Rp, Rp, Rp, Kd, Cd, Cd, Cd, Kd, Rp, Rp, Rp, Rp, Re, Re, Re, Re, Rr, Ket, Wwt^Bw/, Wwt, Wot, Wot, Wot
Gg, Gg, Gg, Gg, Gs, Gg, Gs, Gs, Gg, Gs, Gg, Gg, Gg, Gs, Gs, Gg, Gs, Gg, Gg, Gs, Gs, Gg, Gg, Gg, Gg, Gg, Gs, Gs, Gs, Gg, Gg, Gg, Gg, Gg, Gs, Gg, Gs, Gg, Rp, Rp, Rr^Vda, Rp, Rp, Kd, Kd, Kd, Rp, Rp, Rp, Rp, Kd, Gg, Gg, Gg, Gs, Rr, Wwt, Wwt, Wwt, Wot, Wot, Wot
Gg, Gs, Gs, Gg, Gs, Gg, Gg, Gg, Gg, Gs, Gs, Gg, Gg, Gg, Gg, Gs, Gg, Gs, Gs, Gg, Gg, Gg, Gg, Gg, Gg, Gg, Gg, Gg, Gg, Gg, Gs, Gg, Gg, Gs, Gg, Gg, Gs, Gs, Kd, Rp, Rp, Rp, Rp, Rp, Rp, Rp, Rr^Vda, Rp, Rp, Rp, Cd, Gg, Gg, Gg, Gs, Ds, Wwt, Wwt, Wot, Wot, Wot, Wot
Gs, Gg, Gs, Gg, Gs, Gs, Gg, Gs, Gs, Gg, Gs, Gg, Gs, Gs, Gs, Gg, Gg, Gg, Gg, Gs, Gs, Gs, Gg, Gs, Gg, Gg, Gs, Gs, Gg, Gg, Gg, Gs, Gs, Gs, Gg, Gg, Gs, Gg, Cd, Rp, Rp, Rr^Vda, Rp, Rp, Rp, Rp, Rp, Rp, Rp, Rp, Cd, Gg, Gs, Gs, Ds, Ds, Wwt, Wwt, Wot, Wot, Wot, Wot
Ds, Gs, Ds, Gs, Ds, Gs, Gs, Gg, Gs, Gs, Gs, Gg, Gs, Gs, Gg, Gs, Gg, Gg, Gs, Gg, Gs, Gg, Gg, Gs, Gg, Gs, Gg, Gg, Gg, Gs, Gg, Gs, Gg, Gs, Gs, Gg, Gg, Gg, Cd, Rp, Rp, Rp, Rp, Rr^Vda, Rp, Rp, Rp, Rr^Vda, Rp, Cd, Gg, Gg, Gs, Ds, Wwt, Wwt, Wwt, Wwt, Wot, Wot, Wot, Wot
Ds, Ds, Ds, Ds, Ds, Ds, Ds, Gs, Ds, Gs, Ds, Gs, Ds, Gs, Gs, Gs, Gs, Gg, Gs, Gs, Ds, Gs, Gs, Gg, Gs, Gg, Gg, Gg, Gs, Gg, Gs, Gg, Gg, Gg, Gg, Gs, Gg, Gg, Gg, Cd, Rp, Rp, Rp, Rp, Rp, Rp, Rp, Rp, Rp, Cd, Gg, Gs, Ds, Ds, Wwt, Wwt, Wwt, Wwt, Wot, Wot, Wot, Wot
Wwt, Wwt, Wwt, Ds, Wwt, Ds, Ds, Ds, Ds, Ds, Ds, Ds, Ds, Ds, Ds, Ds, Ds, Gs, Ds, Ds, Ds, Ds, Ds, Gs, Gs, Gs, Gs, Gg, Gs, Gg, Gg, Gg, Gg, Gs, Gg, Gs, Gs, Gg, Gs, Kd, Wwt, Rp, Wwt, Kd, Wot^Bsb|, Kd, Wwt, Rp, Cd, Kd, Gs, Gs, Ds, Wwt, Wwt, Wwt, Wwt, Wot, Wot, Wot, Wot, Wot
Wwt, Wwt, Wwt, Wwt, Wwt, Wwt, Wwt, Wwt, Wwt, Ds, Wwt, Wwt, Wwt, Ds, Wwt, Ds, Ds, Ds, Wwt, Ds, Wwt, Wwt, Wwt, Ds, Ds, Ds, Ds, Gs, Ds, Gs, Gs, Gs, Gs, Gg, Gs, Gg, Gs, Gs, Ds, Ds, Wwt, Wwt, Wwt, Wwt, Wot^Bsb|, Wwt, Wwt, Wwt, Wwt, Ds, Ds, Ds, Wwt, Wwt, Wwt, Wwt, Wot, Wot, Wot, Wot, Wot, Wot
Wot, Wwt, Wot, Wwt, Wot, Wot, Wot, Wwt, Wwt, Wwt, Wwt, Wwt, Wwt, Wwt, Wwt, Wwt, Wwt, Wwt, Wwt, Wwt, Wwt, Wwt, Wwt, Wwt, Wwt, Ds, Ds, Ds, Ds, Ds, Ds, Ds, Ds, Gs, Ds, Gs, Ds, Ds, Wwt, Wwt, Wwt, Wwt, Wwt, Wwt, Wot^Bsb|, Wwt, Wwt, Wwt, Wwt, Wwt, Wwt, Wwt, Wwt, Wot, Wot, Wwt, Wot, Wot, Wot, Wot, Wot, Wot
Wot, Wot, Wot, Wot, Wot, Wot, Wot, Wot, Wot, Wwt, Wot, Wwt, Wot, Wwt, Wwt, Wwt, Wwt, Wwt, Wwt, Wwt, Wot, Wot, Wot, Wwt, Wwt, Wwt, Wwt, Wwt, Wwt, Ds, Wwt, Ds, Wwt, Ds, Wwt, Ds, Wwt, Wwt, Wwt, Wwt, Wwt, Wwt, Ds, Cd, Rp, Cd, Wwt, Wwt, Wwt, Wwt, Wot, Wwt, Wot, Wot, Wot, Wot, Wot, Wot, Wot, Wot, Wot, Wot
Wot, Wot, Wot, Wot, Wot, Wot, Wot, Wot, Wot, Wot, Wot, Wot, Wot, Wot, Wot, Wot, Wot, Wot, Wot, Wot, Wot, Wot, Wot, Wot, Wot, Wwt, Wot, Wwt, Wwt, Wwt, Wwt, Wwt, Wot, Wwt, Wot, Wwt, Wot, Wot, Wot, Wwt, Ds, Ds, Gs^Ft, Gs^Ft, Rp, Rp, Gs^Ft, Wwt, Wwt, Wot, Wot, Wot, Wot, Wot, Wot, Wot, Wot, Wot, Wwrt, Wot, Wot, Wot
Wwrt, Wot, Wwrt, Wot, Wot, Wot, Wot, Wot, Wot, Wot, Wot, Wot, Wot, Wot, Wot, Wot, Wot, Wot, Wot, Wot, Wot, Wot, Wot, Wot, Wot, Wot, Wot, Wot, Wot, Wot, Wot, Wot, Wot, Wot, Wot, Wot, Wot, Wot, Wot, Wwt, Hh^Ft, Hh^Ft, Hh^Ft, Kd, Kd, Gs^Ft, Gs^Ft, Ds, Wwt, Wwt, Wot, Wot, Wot, Wot, Wot, Wot, Wwrt, Wot, Wot, Wot, Wot, Wot
Wot, Wot, Wot, Wot, Wot, Wwrt, Wot, Wot, Wot, Wot, Wot, Wot, Wot, Wot, Wot, Wot, Wot, Wot, Wot, Wot, Wot, Wot, Wot, Wot, Wot, Wot, Wot, Wot, Wot, Wot, Wot, Wot, Wot, Wot, Wot, Wot, Wot, Wot, Wot, Wwt, Hh^Ft, Hh^Ft, Gs^Ft, Kd, Gs^Ft, Gs^Ft, Ds, Ds, Wwt, Wwt, Wot, Wot, Wot, Wot, Wot, Wot, Wot, Wot, Wot, Wot, Wot, Wot
Wot, Wot, Wot, Wot, Wot, Wwrt, Wot, Wot, Wot, Wot, Wot, Wwrt, Wwrt, Wot, Wot, Wot, Wot, Wot, Wot, Wot, Wot, Wot, Wot, Wot, Wot, Wot, Wot, Wot, Wot, Wot, Wot, Wot, Wot, Wot, Wot, Wot, Wot, Wot, Wot, Wwt, Ds, Hh^Ft, Gs^Ft, Gs^Ft, Ds, Gs^Ft, Ds, Wwt, Wot, Wot, Wot, Wot, Wot, Wot, Wwrt, Wwrt, Wot, Wot, Wot, Wot, Wot, Wot
Wot, Wot, Wot, Wot, Wot, Wwrt, Wwrt, Wot, Wot, Wot, Wot, Wot, Wot, Wot, Wot, Wot, Wot, Wot, Wwrt, Wot, Wwrt, Wot, Wwrt, Wot, Wot, Wot, Wot, Wot, Wot, Wwrt, Wot, Wwrt, Wot, Wot, Wot, Wot, Wot, Wot, Wot, Wwt, Wwt, Ds, Ds, Ds, Wwt, Ds, Wwt, Wwt, Wot, Wot, Wot, Wot, Wot, Wot, Wot, Wot, Wot, Wot, Wot, Wot, Wot, Wot
Wot, Wot, Wot, Wot, Wot, Wot, Wot, Wwrt, Wot, Wot, Wot, Wot, Wot, Wot, Wot, Wwrt, Wot, Wwrt, Wot, Wot, Wot, Wot, Wot, Wwrt, Wwrt, Wot, Wot, Wot, Wot, Wot, Wot, Wwrt, Wot, Wot, Wot, Wwrt, Wwrt, Wot, Wot, Wot, Wot, Wwt, Wwt, Wwt, Wot, Wwt, Wot, Wot, Wot, Wot, Wot, Wot, Wot, Wwrt, Wot, Wot, Wot, Wot, Wot, Wot, Wot, Wot
Wot, Wot, Wot, Wot, Wot, Wot, Wot, Wot, Wot, Wot, Wot, Wot, Wot, Wot, Wot, Wot, Wot, Wot, Wot, Wot, Wot, Wot, Wot, Wot, Wwrt, Wot, Wot, Wot, Wot, Wot, Wot, Wot, Wot, Wot, Wot, Wot, Wwrt, Wwrt, Wot, Wot, Wot, Wot, Wot, Wot, Wot, Wot, Wot, Wot, Wot, Wot, Wot, Wot, Wwrt, Wwrt, Wot, Wot, Wot, Wot, Wot, Wot, Wot, Wot
Wot, Wot, Wot, Wot, Wot, Wot, Wot, Wot, Wot, Wot, Wot, Wot, Wot, Wot, Wot, Wot, Wot, Wot, Wot, Wot, Wot, Wot, Wot, Wot, Wot, Wot, Wot, Wot, Wot, Wot, Wot, Wot, Wot, Wot, Wot, Wot, Wot, Wwrt, Wwrt, Wot, Wot, Wot, Wot, Wot, Wot, Wot, Wot, Wot, Wot, Wot, Wot, Wot, Wot, Wot, Wot, Wot, Wot, Wot, Wot, Wot, Wot, Wot
Wot, Wot, Wot, Wot, Wot, Wot, Wot, Wot, Wot, Wot, Wot, Wot, Wot, Wot, Wot, Wot, Wot, Wot, Wot, Wot, Wot, Wot, Wot, Wot, Wot, Wot, Wot, Wot, Wot, Wot, Wot, Wot, Wot, Wot, Wot, Wot, Wot, Wot, Wot, Wot, Wot, Wot, Wot, Wot, Wot, Wot, Wot, Wot, Wot, Wot, Wot, Wot, Wot, Wot, Wot, Wot, Wot, Wot, Wot, Wot, Wot, Wot
