Mm, Mm, Mm, Hh^Fms, Mm, Hhd^Fdw, Hhd^Fdw, Hhd^Fdw, Hhd^Fdw, Hhd^Fdw, Hhd^Fdw, Hhd^Fdw, Gll^Fdw, Gs, Gs, Gs, Gs, Gs, Gs, Gs, Gs, Gs, Gs, Gs, Gs, Gs, Gs, Gs, Gs, Gs, Gs, Gs, Gs, Gs, Hhd^Fdw, Mm, Mm, Mm, Mm, Mm, Mm, Mm, Mm, Mm, Mm, Mm, Mm, Mm, Mm, Mm, Mm, Mm, Mm, Mm
Mm, Mm, Mm, Mm, Hhd^Fdw, Hhd^Fdw, Hhd^Fdw, Hhd^Fdw, Hhd^Fdw, Hhd^Fdw, Hhd^Fdw, Hhd^Fdw, Gll^Fdw, Gll^Fdw, Gs, Gs, Gs, Gs, Gs, Gs, Re^Vct, Gs, Gs, Gs, Gs, Gs, Gs, Gs, Gs, Gs, Gs, Gs, Gs, Gs, Hhd^Fdw, Hhd^Fdw, Mm, Mm, Mm, Mm, Mm, Mm, Mm, Mm, Mm, Mm, Mm, Mm, Mm, Mm, Mm, Mm, Mm, Mm
Mm, Mm, Mm, Mm, Hhd^Fdw, Hhd^Fdw, Hhd^Fdw, Hhd^Fdw, Hhd^Fdw, Hhd^Fdw, Gll^Fdw, Gll^Fdw, Gll^Fdw, Gs, Gs, Gs, Gs, Gs, Gs, Gs, Gs, Gs, Gs, Gs, Re^Vct, Gs, Gs, Gs, Gs, Gs, Gs, Gs, Gs, Gs, Gs, Hhd^Fdw, Hhd^Fdw, Hhd^Fdw, Hhd^Fdw, Mm, Mm, Mm, Hhd^Fdw, Mm, Mm, Mm, Mm, Mm, Mm, Mm, Mm, Mm, Mm, Mm
Mm, Mm, Mm, Hhd^Fdw, Hhd^Fdw, Hhd^Fdw, Hhd^Fdw, Gll^Fdw, Gll^Fdw, Gll^Fdw, Gs, Gll^Fdw, Gs, Gs, Gs, Gs, Re^Vct, Gs, Gs, Gs, Gs, Gs, Gs, Gs, Gs, Gs, Gs, Gs, Gs, Gs, Gs, Gs, Gs, Gs, Gs, Gs, Gs, Hhd^Fdw, Hhd^Fdw, Hhd^Fdw, Hhd^Fdw, Hhd^Fdw, Hhd^Fdw, Hhd^Fdw, Hhd^Fdw, Mm, Mm, Mm, Mm, Mm, Mm, Mm, Mm, Mm
Hhd^Fdw, Hhd^Fdw, Hhd^Fdw, Hhd^Fdw, Hhd^Fdw, Hhd^Fdw, Gll^Fdw, Gll^Fdw, Gll^Fdw, Gll^Fdw, Gs, Gs, Gs, Gs, Gs, Gs, Gs, Gs, Gs, Gs, Ce, Ce, Ce, Gs, Gs, Gs, Gs, Gs, Gs, Gs, Gs, Gs, Gs, Gs, Gs, Gs, Gs, Gs, Gs, Hhd^Fdw, Gs, Hhd^Fdw, Gs, Hhd^Fdw, Hhd^Fdw, Hhd^Fdw, Hhd^Fdw, Mm, Hhd^Fdw, Mm, Mm, Mm, Mm, Mm
Hhd^Fdw, Hhd^Fdw, Hhd^Fdw, Hhd^Fdw, Hhd^Fdw, Hhd^Fdw, Gll^Fdw, Gll^Fdw, Gs, Gs, Gs, Gs, Gs, Gs, Gs, Gs, Gs, Gs, Gs, Gs, Ce, 3 Ke, Ce, Gs, Gs, Gs, Re^Vct, Gs, Gs, Gs, Gs, Gs, Gs, Gs, Gs, Gs, Gs, Gs, Gs, Gs, Gs, Gs, Gs, Hhd^Fdw, Gs, Hhd^Fdw, Hhd^Fdw, Hhd^Fdw, Hhd^Fdw, Mm, Mm, Mm, Mm, Mm
Hhd^Fdw, Hhd^Fdw, Hhd^Fdw, Hhd^Fdw, Hhd^Fdw, Gll^Fdw, Gll^Fdw, Gll^Fdw, Gs, Gs, Gs, Gs, Gs, Gs, Gs, Gs, Gs, Gs, Gs, Gs, Ce, Ce, Ce, Gs, Gs, Gs, Gs, Gs, Gs, Gs, Gs, Gd^Fetd, Gs, Gs, Gs, Gs, Gs, Gs, Gs, Gs, Gs, Gs, Gs, Gs, Gs, Gs, Gs, Hhd^Fdw, Hhd^Fdw, Hhd^Fdw, Mm, Mm, Mm, Mm
Hhd^Fdw, Hhd^Fdw, Hhd^Fdw, Hhd^Fdw, Gll^Fdw, Gll^Fdw, Gll^Fdw, Gs, Gs, Gs, Gs, Gs, Gs, Gs, Gs, Gs, Gs, Gs, Gs, Gs, Gs, Ce, Gs, Gs, Gs, Gs, Gs, Gs, Gs, Gs, Gs, Gs, Gs, Gs, Gs, Gs, Gs, Gs, Gs, Gs, Gll^Fdw, Gs, Gs, Gs, Gs, Gs, Gs, Gs, Hhd^Fdw, Hhd^Fdw, Hhd^Fdw, Mm, Mm, Mm
Hhd^Fdw, Hhd^Fdw, Hhd^Fdw, Gll^Fdw, Gll^Fdw, Gll^Fdw, Gll^Fdw, Gs, Gs, Gs, Gs, Gs, Gs, Gs, Gs, Gs, Gs, Gs, Re^Vct, Gs, Gs, Gs, Gs, Gs, Re^Vct, Gs, Gs, Gs, Gs, Gs, Gs, Gs, Gs, Gs, Gs, Gs, Gs, Gs, Gll^Fdw, Gll^Fdw, Gd^Fetd, Gll^Fdw, Gll^Fdw, Gs, Gs, Gs, Gs, Gs, Gs, Hhd^Fdw, Hhd^Fdw, Mm, Mm, Mm
Hhd^Fdw, Hhd^Fdw, Gll^Fdw, Gll^Fdw, Gll^Fdw, Gll^Fdw, Gs, Gs, Gs, Gs, Gs, Gs, Gs, Gs, Gs, Gd^Fetd, Gs, Gs, Gs, Gs, Gs, Gs, Gs, Gs, Gs, Gs, Gs, Gd^Fetd, Gs, Gs, Gs, Gs, Gs, Gs, Gs, Gs, Gs, Gs, Gll^Fdw, Gll^Fdw, Gll^Fdw, Gll^Fdw, Gll^Fdw, Gll^Fdw, Gll^Fdw, Gs, Gs, Gd^Vo, Gs, Gs, Hhd^Fdw, Hhd^Fdw, Hhd^Fdw, Mm
Gll^Fdw, Gll^Fdw, Gll^Fdw, Gll^Fdw, Gs, Gs, Gs, Gs, Gs, Gs, Gs, Gs, Gs, Gs, Gs, Gs, Gs, Gs, Gs, Gs, Gs, Gs, Gs, Gs, Gs, Gs, Gs, Gs, Gs, Gs, Gs, Gs, Gs, Gs, Gs, Gs, Gs, Gs, Gs, Gll^Fdw, Gll^Fdw, Gll^Fdw, Gd^Fetd, Gll^Fdw, Gll^Fdw, Gs, Gs, Gs, Gs, Gs, Gs, Hhd^Fdw, Gs, Hhd^Fdw
Gll^Fdw, Gll^Fdw, Gs, Gs, Gs, Gs, Gs, Gs, Gs, Gs, Gs, Gs, Gs, Gs, Gs, Gs, Gs, Gs, Gs, Gs, Gs, Gs, Gs, Gs, Gs, Gs, Gs, Gs, Gs, Gs, Gs, Gs, Gs, Gs, Gs, Gs, Gs, Gs, Gs, Gs, Gs, Gll^Fdw, Gs, Gll^Fdw, Gs, Gs, Gs, Gs, Gs, Gs, Gs, Gs, Gs, Gs
Gll^Fdw, Gll^Fdw, Gs, Gs, Gs, Gs, Gs, Gs, Gs, Gs, Gs, Gs, Gs, Gs, Gs, Gs, Gs, Gs, Gs, Gs, Gs, Gs, Gs, Gd^Fetd, Gs, Gs, Gs, Gs, Gs, Gs, Gs, Gs, Gs, Gs, Gs, Gs, Gs, Gs, Gs, Gs, Gs, Gs, Gs, Gs, Gs, Gs, Ce, Ce, Ce, Gs, Gs, Gd^Vo, Gs, Gs
Gll^Fdw, Gs, Gs, Gs, Gs, Gs, Gs, Gs, Gs, Gs, Gs, Gs, Gs, Gs, Gs, Gs, Gs, Gs, Gs, Gs, Gs, Gs, Gs, Gs, Gs, Gs, Gs, Gs, Gs, Gs, Gs, Gs, Hhd^Fdw, Hhd^Fdw, Hhd^Fdw, Hhd^Fdw, Hhd^Fdw, Gs, Gs, Gs, Gs, Gs, Gs, Gs, Gs, Gs, Ce, 1 Ke, Ce, Gs, Gs, Gs, Gs, Gs
Gs, Gs, Gs, Gs, Gs, Gs, Gs, Gs, Gs, Gs, Gs, Gs, Hhd, Gs, Hhd, Gs, Hhd, Gs, Hhd, Gs, Gs, Gs, Gs, Gs, Gs, Gs, Gs, Gs, Gs, Gs, Gs, Gs, Hhd^Fdw, Hhd, Hhd, Hhd^Fdw, Hhd, Hhd^Fdw, Hhd^Fdw, Gs, Hhd^Fdw, Gs, Gs, Gs, Gs, Gs, Gs, Ce, Gs, Gs, Gs, Gs, Ww, Ww
Gs, Gs, Gs, Gs, Gs, Gs, Gs, Gs, Hhd, Hhd, Hhd, Hhd, Hhd, Hhd, Hhd, Hhd, Hhd, Hhd, Hhd, Hhd, Gs, Gs, Gs, Gs, Gs, Gs, Gs, Gs, Gs, Gs, Gs, Gs, Hhd^Fdw, Hhd, Hhd, Hhd, Hhd, Hhd, Hhd, Hhd^Fdw, Hhd^Fdw, Hhd^Fdw, Gs, Gd^Vo, Gs, Gs, Gs, Gs, Gs, Gs, Gs, Ww, Wo, Wo
Gs, Gs, Gs, Gs, Gs, Gs, Gs, Gs, Hhd, Hhd, Hhd^Fdw, Hhd, Hhd^Fdw, Hhd^Fdw, Hhd^Fdw, Hhd^Fdw, Hhd^Fdw, Hhd^Fdw, Hhd^Fdw, Hhd, Hhd, Gs, Co, Gs, Co, Gs, Gs, Gs, Gs, Gs, Co, Gs, Co, Hhd^Fdw, Hhd^Fdw, Hhd, Hhd, Hhd, Hhd, Hhd, Hhd, Hhd^Fdw, Hhd^Fdw, Gs, Gs, Gs, Gd^Fetd, Gs, Gs, Gs, Ww, Ww, Wo, Wo
Gs, Gs, Gs, Gs, Gs, Gs, Hhd, Hhd, Hhd^Fdw, Hhd^Fdw, Hhd^Fdw, Hhd^Fdw, Hhd, Hhd^Fdw, Hhd, Hhd^Fdw, Hhd, Hhd, Hhd, Hhd, Hhd, Co, Gs, Co, Gs, Ko, Gs, Gs, Gs, Ko, Gs, Co, Gs, Gs, Hhd^Fdw, Hhd, Hhd^Fdw, Hhd, Hhd, Hhd, Hhd, Hhd, Hhd^Fdw, Gs, Gs, Gs, Gs, Gs, Gs, Gs, Ww, Wo, Ww, Ww
Gs, Gs, Gs, Gs, Gs, Gs, Hhd, Hhd^Fdw, Hhd^Fdw, Hhd^Fdw, Hhd^Fdw, Hhd^Fdw, Hhd, Hhd, Hhd, Hhd, Gs, Hhd, Gs, Hhd, Gs, Gs, Gs, Gs, Gs, Gs, Gs, Gs, Gs, Gs, Gs, Gs, Gs, Gs, Gs, Hhd^Fdw, Hhd^Fdw, Hhd, Hhd, Hhd, Hhd, Hhd, Hhd, Hhd^Fdw, Hhd^Fdw, Gs, Gs, Gs, Gs, Ww, Wo, Wo, Ww, Gs
Gs, Gs, Gs, Gs, Gs, Hhd, Hhd, Hhd^Fdw, Hhd^Fdw, Hhd^Fdw, Hhd, Hhd, Gs, Gs, Gs, Gs, Gs, Gs, Gs, Gs, Gs, Gs, Gs, Gs, Gs, Gs, Gs, Gs, Gs, Gs, Gs, Gs, Gd^Vo, Gs, Gs, Gs, Gs, Hhd^Fdw, Hhd^Fdw, Hhd, Hhd, Hhd, Hhd, Hhd, Hhd^Fdw, Gs, Gs, Gs, Gs, Ww, Wo, Ww, Gs, Gs
Gs, Gs, Gs, Gs, Gs, Hhd, Hhd^Fdw, Hhd^Fdw, Hhd^Fdw, Hhd, Hhd, Hhd, Gs, Gs, Gs, Gs, Gd, Gs, Gd, Gs, Gs, Gs, Gd^Vo, Gs, Gs, Gs, Gs, Gs, Gs, Gs, Gd, Gd, Gs, Gs, Gs, Gs, Gs, Hhd^Fdw, Hhd^Fdw, Hhd, Hhd, Hhd, Hhd, Hhd, Hhd^Fdw, Gs, Gs, Gs, Gs, Ww, Wo, Ww, Gs, Gs
Gs, Gs, Gs, Gs, Hhd, Hhd, Hhd^Fdw, Hhd^Fdw, Hhd, Hhd, Gs, Gs, Gs, Gs, Gs, Gd, Gs, Gs, Gs, Gs, Gs, Gs, Gs, Gs, Gs, Gs, Gs, Gs, Gs, Gs, Gs, Gs, Gs, Gs, Gd, Gs, Gs, Gs, Gs, Hhd^Fdw, Hhd, Hhd, Hhd, Hhd, Hhd^Fdw, Hhd^Fdw, Gs, Gs, Gs, Ww, Wo, Ww, Gs, Gs
Gs, Gs, Gs, Gs, Hhd, Hhd^Fdw, Hhd^Fdw, Hhd^Fdw, Hhd, Hhd, Gs, Gs, Gs, Gs, Gs, Gd, Gs, Gs, Gd, Gs, Gs, Gs, Gs, Gd, Gs, Gs, Gs, Gd, Gd, Gs, Gs, Gs, Gs, Gs, Gd, Gs, Gs, Gs, Gs, Hhd^Fdw, Hhd, Hhd, Hhd, Hhd, Hhd^Fdw, Hhd^Fdw, Gs, Gs, Gs, Ww, Wo, Ww, Gs, Gs
Gs, Gs, Gs, Gs, Hhd, Hhd, Hhd^Fdw, Hhd, Hhd, Hhd, Gs, Gs, Gs, Gs, Gs, Gs, Gs, Gs, Gs, Gd, Gs, Gs, Gs, Gs, Gs, Gs, Gs, Gs, Gs, Gs, Gs, Gs, Gs, Gs, Gs, Gs, Gs, Gs, Gs, Hhd^Fdw, Hhd^Fdw, Hhd, Hhd, Hhd, Hhd^Fdw, Hhd^Fdw, Hhd^Fdw, Gs, Hhd^Fdw, Ww, Wo, Ww, Gs, Gs
Gs, Gs, Gs, Gs, Hhd, Hhd, Hhd, Hhd^Fdw, Hhd^Fdw, Hhd, Gs, Gs, Gs, Gs, Gs, Gs, Gs, Gs, Gs, Gs, Gs, Gs, Gs, Gs, Gs, Gs, Gs, Gs, Gs, Gs, Gd, Gs, Gs, Gs, Gs, Gs, Gs, Gs, Gs, Gs, Hhd^Fdw, Hhd, Hhd, Hhd, Hhd^Fdw, Hhd^Fdw, Hhd^Fdw, Hhd^Fdw, Hhd^Fdw, Ww, Wo, Ww, Gs, Gs
Gs, Gs, Gs, Gs, Gs, Hhd, Hhd, Hhd, Hhd^Fdw, Hhd, Hhd, Gs, Gs, Gs, Gs, Gd, Gs, Gs, Gd^Vo, Gs, Gs, Gs, Gs, Gs, Gs, Gs, Gs, Gs, Gs, Gs, Gs, Gs, Gd^Vo, Gs, Gs, Gd, Gs, Gs, Gs, Hhd^Fdw, Hhd^Fdw, Hhd, Hhd, Hhd, Hhd^Fdw, Hhd^Fdw, Hhd^Fdw, Hhd^Fdw, Hhd^Fdw, Ww, Wo, Ww, Gs, Gs
Gs, Gs, Gs, Gs, Gs, Gs, Gs, Hhd, Hhd, Hhd, Hhd, Gs, Gs, Gs, Gs, Gd, Gs, Gs, Gs, Gs, Gs, Gs, Gs, Gs, Gs, Gs, Gs, Gs, Gs, Gs, Gs, Gs, Gs, Gs, Gs, Gs, Gs, Gs, Hhd^Fdw, Hhd^Fdw, Hhd, Hhd, Hhd^Fdw, Hhd^Fdw, Hhd^Fdw, Hhd^Fdw, Hhd^Fdw, Hhd^Fdw, Ww, Ww, Wo, Ww, Gs, Gs
Gs, Gs, Gs, Gs, Gs, Gs, Gs, Hhd, Hhd, Hhd, Gs, Gs, Gs, Gs, Gs, Gs, Gs, Gs, Gs, Gs, Gs, Gs, Gs, Gs, Ww^Bcx|, Ww^Bcx|, Ww^Bcx|, Gs, Gs, Gs, Gs, Gs, Gs, Gs, Gs, Gd, Gs, Gs, Hhd^Fdw, Hhd, Hhd^Fdw, Hhd^Fdw, Hhd^Fdw, Hhd^Fdw, Hhd^Fdw, Hhd^Fdw, Ww, Ww, Wo, Wo, Ww, Ww, Gs, Gs
Gs, Gs, Gs, Gs, Gs, Gs, Gs, Gs, Gs, Gs, Gs, Gs, Gs, Gs, Gs, Gs, Gs, Gs, Gs, Gs, Gs, Gs, Ww, Ww, Urb, Urb, Urb, Ww, Ww, Gs, Gs, Gs, Gs, Gs, Gs, Gd, Gs, Gs, Gs, Hhd^Fdw, Hhd^Fdw, Hhd^Fdw, Hhd^Fdw, Hhd^Fdw, Ww, Ww, Wo, Wo, Ww, Ww, Gs, Gs, Gs, Gs
Gs, Gs, Gs, Gs, Gs, Gs, Gs, Gs, Hhd^Fdw, Gs, Gs, Gs, Gs, Gs, Gd^Vo, Gs, Gs, Gs, Gs, Gs, Ww, Ww, Ko, Ko, Urb, Urb, Urb, Ko, Ko, Ww, Ww, Gs, Gs, Gs, Gs, Gs, Gs, Gs, Gs, Gs, Gs, Hhd^Fdw, Hhd^Fdw, Hhd^Fdw, Ww, Wo, Ww, Ww, Gs, Gs, Gs, Gs, Gs, Gs
Gs, Gs, Gs, Gs, Gs, Gs, Hhd^Fdw, Hhd^Fdw, Hhd^Fdw, Hhd^Fdw, Hhd^Fdw, Gs, Gs, Gs, Gs, Gs, Gs, Gs, Gs, Ww, Ko, Ko, Urb, Urb, Urb, Urb, Urb^Vo, Urb, Urb, Ko, Ko, Ww, Gs, Gs, Gs, Gd, Gs, Gs, Gs, Gs, Gs, Hhd^Fdw, Ww, Ww, Wo, Ww, Gs, Gs, Gs, Gs, Gs, Gs, Gs, Gs
Gs, Gs, Gs, Gs, Gs, Hhd^Fdw, Hhd^Fdw, Hhd, Hhd, Hhd, Hhd^Fdw, Gs, Gs, Gs, Gs, Gs, Gs, Gs, Gs, Ww, Ko, Urb, Urb, Urb^Vo, Urb, Urb, Urb, Urb, Urb^Vo, Urb, Ko, Ww, Gs, Gs, Gs, Gs, Gs, Gs, Gs, Gs, Ww, Ww, Wo, Wo, Ww, Ww, Ss, Gs, Gs, Gs, Gs, Gs, Gs, Gs
Gs, Gs, Gs, Gs, Gs, Hhd^Fdw, Hhd, Hhd, Hhd, Hhd, Hhd, Hhd^Fdw, Hhd^Fdw, Gs, Gs, Gs, Gs, Gs, Gs, Ww, Ko, Urb, Urb, Urb, Urb, Co, Urb, Urb, Urb, Urb, Ko, Ww, Gs, Gs, Gs, Gd, Gs, Gs, Gs, Gs, Ww, Wo, Ww, Ww, Ss, Ss, Ss, Ss, Ss, Gs, Gs, Gs, Gs, Gs
Gs, Gs, Gs, Gs, Gs, Hhd^Fdw, Hhd, Hhd, Hhd^Fdw, Hhd, Hhd, Hhd, Hhd^Fdw, Gs, Gs, Gd, Gs, Gs, Gs, Ww, Ko, Urb, Urb, Co, Co, Co, Co, Co, Urb, Urb, Ko, Ww, Gs, Gs, Gs, Gs, Gs, Gs, Ss, Ss, Ww, Wo, Ww, Ss, Ss, Ss, Ss, Ss, Ss, Gs, Gs, Gs, Gs, Gs
Gs, Gs, Gs, Gs, Gs, Hhd^Fdw, Hhd, Hhd, Hhd^Fdw, Hhd^Fdw, Hhd, Hhd, Hhd^Fdw, Gs, Gs, Gs, Gs, Gs, Gs, Ww^Bcx\, Urb, Urb, Urb, Urb, Co, 2 Ko, Co, Urb, Urb, Urb, Urb, Ww^Bcx/, Gs, Gs, Gs, Gs, Gs, Gs, Ss, Ss, Ww, Wo, Ww, Ss, Ss, Ss, Ss, Ss, Ds, Gs, Gs, Gs, Gs, Gs
Gs, Gs, Gs, Gs, Gs, Hhd^Fdw, Hhd, Hhd, Hhd^Fdw, Hhd^Fdw, Hhd, Hhd, Hhd^Fdw, Gs, Gs, Gd, Gs, Gs, Gs, Ww^Bcx/, Ko, Urb, Urb, Co, Urb, Co, Urb, Co, Urb, Urb, Ko, Ww^Bcx\, Gs, Gs, Gs, Gs, Gs, Ss, Ss, Ss, Ww, Wo, Ww, Ww, Ww, Ss, Ds, Ds, Ww, Ds, Gs, Gs, Gs, Gs
Gs, Gs, Gs, Gs, Gs, Hhd^Fdw, Hhd^Fdw, Hhd, Hhd, Hhd^Fdw, Hhd, Hhd^Fdw, Hhd^Fdw, Gs, Gs, Gs, Gs, Gs, Gs, Ww, Ko, Urb, Urb, Urb, Urb, Co, Urb, Urb, Urb, Urb, Ko, Ww, Sm, Sm, Sm, Sm, Sm, Ss, Ww, Ww, Wo, Wo, Wo, Ww, Ww, Ww, Ww, Ww, Ww, Ds, Ds, Gs, Gs, Gs
Gs, Gs, Gs, Gs, Gs, Hhd^Fdw, Hhd^Fdw, Hhd, Hhd, Hhd, Hhd, Hhd^Fdw, Gs, Gs, Gs, Gd^Vo, Gs, Gs, Gs, Ww, Ko, Urb, Urb^Vo, Urb, Urb, Urb, Urb, Urb, Urb^Vo, Urb, Ko, Ww, Ww, Sm, Sm, Sm, Ww, Ww, Ww, Ww, Wo, Wo, Wo, Wo, Wo, Wo, Wo, Wo, Wo, Ww, Ww, Ss, Gs, Gs
Gs, Gs, Gs, Gs, Gs, Hhd^Fdw, Hhd^Fdw, Hhd, Hhd, Hhd, Hhd, Hhd^Fdw, Gs, Gs, Gs, Gd, Gs, Gs, Gs, Ww, Ko, Urb, Urb, Urb, Urb, Urb^Vo, Urb, Urb, Urb, Urb, Ko, Ww, Sm, Ww, Ww, Ww, Ww, Ww, Wo, Wo, Wo, Wo, Wo, Wo, Wo, Wo, Wo, Wo, Wo, Wo, Ww, Ss, Gs, Gs
Gs, Gs, Gd, Gs, Gs, Gs, Hhd^Fdw, Hhd^Fdw, Hhd^Fdw, Hhd, Hhd^Fdw, Hhd^Fdw, Gll, Gs, Gs, Gs, Gs, Gs, Gs, Ww, Ww, Ko, Ko, Urb, Urb, Urb, Urb, Urb, Ko, Ko, Ww, Ww, Gs, Sm, Sm, Ww, Ww, Wo, Wo, Wo, Wo, Wo, Wo, Wo, Wo, Wo, Wo, Wo, Wo, Wo, Ww, Ds, Gs, Gs
Gs, Gs, Gs, Gd, Gs, Gs, Gs, Hhd^Fdw, Gs, Hhd^Fdw, Gll, Gd, Gll, Gll, Gs, Gs, Hhd^Fdw, Gs, Gs, Gs, Gs, Ww, Ww, Ko, Urb, Urb, Urb, Ko, Ww, Ww, Gs, Gs, Gs, Gs, Sm, Ww, Ww, Wo, Wo, Wo, Wo, Wo, Wo, Wo, Wo, Wo, Wo, Wo, Wo, Wo, Ww, Ds, Ds, Gs
Gs, Gs, Gs, Gs, Gs, Gs, Gs, Gs, Gs, Gs, Gll, Gd, Hhd^Fdw, Hhd^Fdw, Hhd^Fdw, Hhd^Fdw, Hhd, Hhd^Fdw, Gs, Gs, Gs, Gs, Gs, Ww, Ww^Bcx|, Urb, Ww^Bcx|, Ww, Gs, Gs, Gs, Gs, Gs, Gs, Sm, Ww, Ww, Wo, Wo, Wo, Wo, Wo, Wo, Wo, Wo, Wo, Wo, Wo, Wo, Wo, Ww, Ww, Ds, Gs
Gs, Gs, Gs, Gs, Gs, Gd, Gs, Gs, Gs, Gs, Gs, Hhd^Fdw, Hhd^Fdw, Hhd^Fdw, Hhd, Hhd, Hhd, Hhd, Gs, Gs, Gs, Gs, Gs, Gs, Gs, Ww^Bcx|, Gs, Gs, Gs, Gs, Gs, Gs, Gs, Gs, Gs, Ds, Ww, Ww, Wo, Wo, Wo, Wo, Wo, Wo, Wo, Wo, Wo, Wo, Ww, Ww, Ds, Ds, Gs, Gs
Gs, Gs, Gd, Gs, Gs, Gs, Gs, Gs, Gd, Gs, Gs, Hhd^Fdw, Hhd^Fdw, Hhd, Hhd, Hhd, Hhd, Hhd, Gs, Gs, Gs, Gd^Vo, Gd, Gs, Gs, Gs, Gs, Gs, Gd, Gs, Gs, Gs, Gs, Gs, Gs, Ds, Ww, Wo, Wo, Wo, Wo, Wo, Wo, Wo, Ww, Wo, Wo, Wo, Ww, Ds, Gs, Gs, Gll^Fdw, Gll^Fdw
Gs, Gs, Gs, Gs, Gs, Gd^Vo, Gs, Gs, Gd, Gd, Hhd^Fdw, Hhd^Fdw, Hhd^Fdw, Hhd, Hhd, Hhd, Hhd, Hhd, Hhd, Gs, Gs, Gs, Gs, Gs, Gs, Gs, Gs, Gs, Gs, Gd, Gd^Vo, Gs, Gs, Gs, Gs, Ds, Ds, Ww, Wo, Wo, Wo, Wo, Ww, Ww, Ww, Ww, Ww, Ww, Ww, Ds, Gs, Gll^Fdw, Gll^Fdw, Gll^Fdw
Gs, Gs, Gs, Gs, Gs, Gs, Gs, Gs, Gd, Gs, Gs, Hhd^Fdw, Hhd^Fdw, Hhd, Hhd, Hhd, Hhd, Hhd, Hhd, Gs, Gs, Gs, Hhd, Hhd, Hhd, Gs, Gs, Gs, Gs, Gs, Gs, Gs, Gs, Gs, Gs, Gs, Ds, Ww, Ww, Wo, Ww, Ww, Ds, Ss, Ss, Ww, Ss, Ds, Ds, Ds, Gll^Fdw, Gll^Fdw, Gll^Fdw, Gll^Fdw
Gs, Gs, Gs, Gd, Gs, Gs, Gs, Gs, Gs, Gs, Gs, Hhd^Fdw, Hhd^Fdw, Hhd^Fdw, Hhd^Fdw, Hhd, Hhd, Hhd, Hhd, Hhd, Hhd, Hhd, Hhd, Hhd, Hhd, Hhd, Hhd, Gs, Gs, Gs, Gs, Gs, Gs, Gs, Gs, Gs, Gs, Ds, Ds, Ds, Ds, Ww, Ds, Ss, Ss, Ss, Ss, Gs, Gs, Gll^Fdw, Gll^Fdw, Gll^Fdw, Hhd^Fdw, Gll^Fdw
Gs, Gs, Gs, Gs, Gd, Gs, Gs, Gs, Gs, Gs, Gs, Gs, Hhd^Fdw, Hhd^Fdw, Hhd^Fdw, Hhd, Hhd, Hhd, Hhd, Hhd, Hhd, Hhd, Hhd, Hhd, Hhd, Hhd, Hhd, Hhd^Fdw, Gs, Gs, Gs, Gs, Gs, Gs, Gs, Gs, Gs, Gs, Gs, Gs, Gs, Ds, Gs, Gs, Gll^Fdw, Gll^Fdw, Gll^Fdw, Gs, Gll^Fdw, Gll^Fdw, Gll^Fdw, Hhd^Fdw, Hhd^Fdw, Hhd^Fdw
Gs, Gs, Gs, Gs, Gs, Gd, Gs, Gd, Re^Vct, Gs, Gs, Gs, Gs, Hhd^Fdw, Hhd^Fdw, Hhd, Hhd, Hhd, Hhd, Hhd, Hhd, Hhd, Hhd, Hhd, Hhd, Hhd, Hhd^Fdw, Hhd^Fdw, Gs, Gs, Gs, Gs, Gs, Gd, Gd, Gd^Vo, Gs, Gs, Gs, Gs, Gs, Gs, Gll^Fdw, Gs, Gll^Fdw, Gll^Fdw, Hhd^Fdw, Gll^Fdw, Gll^Fdw, Gll^Fdw, Gll^Fdw, Hhd^Fdw, Hhd^Fdw, Hhd^Fdw
Gs, Gs, Gs, Gs, Gs, Gs, Gs, Gs, Gs, Gs, Gs, Gs, Gs, Hhd^Fdw, Hhd^Fdw, Hhd^Fdw, Hhd^Fdw, Hhd, Hhd, Hhd, Hhd, Hhd, Hhd, Hhd, Hhd, Hhd, Hhd^Fdw, Hhd^Fdw, Gs, Gs, Gs, Gs, Gd, Gs, Gs, Gs, Gs, Gs, Gll^Fdw, Gs, Gll^Fdw, Gll^Fdw, Gll^Fdw, Gll^Fdw, Gll^Fdw, Gll^Fdw, Hhd^Fdw, Hhd^Fdw, Hhd^Fdw, Hhd^Fdw, Hhd^Fdw, Hhd^Fdw, Hhd^Fdw, Hhd^Fdw
Gs, Gs, Gs, Re^Vct, Gs, Gs, Ce, Gs, Gs, Gs, Gd, Gs, Gs, Gs, Hhd^Fdw, Hhd^Fdw, Hhd^Fdw, Hhd^Fdw, Hhd^Fdw, Hhd, Hhd^Fdw, Hhd^Fdw, Hhd^Fdw, Hhd, Hhd^Fdw, Hhd^Fdw, Hhd^Fdw, Hhd^Fdw, Gs, Gs, Gs, Gs, Gs, Gs, Gs, Gs, Gll^Fdw, Gll^Fdw, Hhd^Fdw, Gll^Fdw, Hhd^Fdw, Gll^Fdw, Hhd^Fdw, Hhd^Fdw, Hhd^Fdw, Hhd^Fdw, Hhd^Fdw, Hhd^Fdw, Hhd^Fdw, Hhd^Fdw, Hhd^Fdw, Hhd^Fdw, Hhd^Fdw, Hhd^Fdw
Gs, Gs, Gs, Gs, Gs, Ce, Ce, Ce, Gs, Gs, Gs, Gd, Gs, Gs, Gs, Hhd^Fdw, Hhd^Fdw, Hhd^Fdw, Hhd^Fdw, Hhd^Fdw, Hhd^Fdw, Hhd^Fdw, Hhd^Fdw, Hhd^Fdw, Hhd^Fdw, Hhd^Fdw, Gs, Gs, Gs, Gs, Gs, Gs, Gs, Gs, Gs, Gs, Gll^Fdw, Gll^Fdw, Hhd^Fdw, Hhd^Fdw, Hhd^Fdw, Hhd^Fdw, Hhd^Fdw, Hhd^Fdw, Hhd^Fdw, Hhd^Fdw, Hhd^Fdw, Hhd^Fdw, Hhd^Fdw, Hhd^Fdw, Hhd^Fdw, Hhd^Fdw, Hhd^Fdw, Hhd^Fdw
Gs, Gs, Re^Vct, Gs, Gs, Ce, 4 Ke, Ce, Gs, Gs, Gs, Gd, Gs, Gs, Gs, Gs, Gs, Gs, Gs, Gs, Gs, Gs, Gs, Hhd^Fdw, Gs, Gs, Gs, Gs, Gs, Gs, Gs, Gs, Gs, Gs, Gs, Gll^Fdw, Gll^Fdw, Hhd^Fdw, Hhd^Fdw, Hhd^Fdw, Hhd^Fdw, Hhd^Fdw, Hhd^Fdw, Hhd^Fdw, Hhd^Fdw, Hhd^Fdw, Hhd^Fdw, Hhd^Fdw, Hhd^Fdw, Hhd^Fdw, Hhd^Fdw, Hhd^Fdw, Hhd^Fdw, Hhd^Fdw
Gs, Gs, Gs, Gs, Gs, Ce, Ce, Ce, Gs, Gs, Gs, Re^Vct, Gs, Gs, Gd, Gs, Gs, Gs, Gd, Gs, Gs, Gs, Gs, Gs, Gs, Gs, Gs, Gs, Gd^Vo, Gs, Gs, Gs, Gs, Gs, Gll^Fdw, Gll^Fdw, Hhd^Fdw, Hhd^Fdw, Hhd^Fdw, Hhd^Fdw, Hhd^Fdw, Hhd^Fdw, Hhd^Fdw, Hhd^Fdw, Hhd^Fdw, Hhd^Fdw, Hhd^Fdw, Hhd^Fdw, Hhd^Fdw, Hhd^Fdw, Hhd^Fdw, Hhd^Fdw, Hhd^Fdw, Hhd^Fdw
Gs, Gs, Gs, Gs, Gs, Gs, Gs, Gs, Gs, Re^Vct, Gs, Gs, Re^Vct, Gs, Gs, Gd, Gs, Gs, Gs, Gs, Gs, Gs, Gs, Gs, Gs, Gs, Gd, Gs, Gd, Gs, Gs, Gs, Gs, Gll^Fdw, Gll^Fdw, Hhd^Fdw, Hhd^Fdw, Hhd^Fdw, Hhd^Fdw, Hhd^Fdw, Hhd^Fdw, Hhd^Fdw, Hhd^Fdw, Hhd^Fdw, Hhd^Fdw, Hhd^Fdw, Hhd^Fdw, Hhd^Fdw, Hhd^Fdw, Hhd^Fdw, Hhd^Fdw, Hhd^Fdw, Hhd^Fdw, Hhd^Fdw
Gs, Gs, Gs, Gs, Gs, Gs, Gs, Gs, Gs, Gs, Gs, Gs, Gs, Gs, Gs, Gs, Gs, Gs, Gs, Gs, Gs, Gs, Gd, Gd, Gs, Gd, Gs, Gs, Gs, Gs, Gs, Gs, Gll^Fdw, Gll^Fdw, Gll^Fdw, Hhd^Fdw, Hhd^Fdw, Hhd^Fdw, Hhd^Fdw, Hhd^Fdw, Hhd^Fdw, Hhd^Fdw, Hhd^Fdw, Hhd^Fdw, Hhd^Fdw, Hhd^Fdw, Hhd^Fdw, Hhd^Fdw, Hhd^Fdw, Hhd^Fdw, Hhd^Fdw, Hhd^Fdw, Hhd^Fdw, Hhd^Fdw
Gs, Gs, Gs, Gs, Re^Vct, Gs, Gs, Gs, Re^Vct, Gs, Gs, Gs, Gs, Gs, Gs, Gs, Gs, Gs, Gs, Gs, Gs, Gs, Gs, Gs, Gs, Gs, Gs, Gs, Gs, Gs, Gs, Gs, Gll^Fdw, Gll^Fdw, Gll^Fdw, Hhd^Fdw, Hhd^Fdw, Hhd^Fdw, Hhd^Fdw, Hhd^Fdw, Hhd^Fdw, Hhd^Fdw, Hhd^Fdw, Hhd^Fdw, Hhd^Fdw, Hhd^Fdw, Hhd^Fdw, Hhd^Fdw, Hhd^Fdw, Hhd^Fdw, Hhd^Fdw, Hhd^Fdw, Hhd^Fdw, Hhd^Fdw
Gs, Gs, Gs, Gs, Gs, Gs, Gs, Gs, Gs, Gs, Gs, Gs, Gs, Gs, Gs, Gs, Gs, Gs, Gs, Gs, Gs, Gs, Gs, Gs, Gs, Gs, Gs, Gs, Gs, Gs, Gs, Gll^Fdw, Gll^Fdw, Gll^Fdw, Hhd^Fdw, Hhd^Fdw, Hhd^Fdw, Hhd^Fdw, Hhd^Fdw, Hhd^Fdw, Hhd^Fdw, Hhd^Fdw, Hhd^Fdw, Hhd^Fdw, Hhd^Fdw, Hhd^Fdw, Hhd^Fdw, Hhd^Fdw, Hhd^Fdw, Hhd^Fdw, Hhd^Fdw, Hhd^Fdw, Hhd^Fdw, Hhd^Fdw
Gs, Gs, Gs, Gs, Gs, Gs, Gs, Gs, Gs, Gs, Gs, Gs, Gs, Gs, Gs, Gs, Gs, Gs, Gs, Gs, Gs, Gs, Gs, Gs, Gs, Gs, Gs, Gs, Gs, Gs, Gs, Gll^Fdw, Gll^Fdw, Hhd^Fdw, Hhd^Fdw, Hhd^Fdw, Hhd^Fdw, Hhd^Fdw, Hhd^Fdw, Hhd^Fdw, Hhd^Fdw, Hhd^Fdw, Hhd^Fdw, Hhd^Fdw, Hhd^Fdw, Hhd^Fdw, Hhd^Fdw, Hhd^Fdw, Hhd^Fdw, Hhd^Fdw, Hhd^Fdw, Hhd^Fdw, Hhd^Fdw, Hhd^Fdw
