Gs, Gs, Gs, Gs, Ww, Ww, Wo, Ww, Gs, Gs, Gs, Gs, Gs, Gs, Gs, Gs, Gs, Gs, Gs, Gs, Gs, Gs, Gs, Gs, Gs, Gs, Gs, Gs, Wwf, Gs, Gs, Gs, Gs, Ww, Gs, Gs, Gs, Gs, Gs, Gs, Gs, Gs, Gs, Gs, Gs, Gs
Gs, Gs, Gs, Gs, Ww, Wo, Wo, Ww, Gs, Gs, Gs, Gs, Gs, Gs, Gs, Gs, Gs, Gs, Gs, Gd, Gs, Gs, Gs, Gs, Ce, Gs, Gs, Gs, Wwf, Gs, Gs, Gs, Gs, Wwrg, Gs, Gs, Gs, Gs, Hhd, Hhd, Hhd, Gs, Gs, Gs, Gs, Gs
Hhd, Gs, Gs, Gs, Gs, Ww, Wo, Ww, Gs, Gs, Gs, Gs, Gs, Gs, Gd^Vo, Gs, Gs, Gd, Gs, Gd, Gd, Gs, Gs, Ce, 1 Ke, Ce, Gs, Gs, Gs, Wwf, Gs, Gd^Vo, Gs, Ww, Wwrg, Gs, Gs, Hhd, Hhd, Hhd, Hhd, Hhd, Hhd, Gs, Gs, Gs
Hhd, Hhd, Hhd, Gs, Gs, Ww, Wo, Ww, Gs, Gs, Gs, Gs, Gs, Gs, Gs, Gd, Gs, Gs, Gs, Gs, Gs, Gs, Gd, Ce, Ce, Ce, Gs, Gs, Wwf, Wwf, Gs, Gs, Gs, Gs, Wwrg, Gd, Gs, Hhd, Hhd, Hhd, Hhd, Hhd, Hhd, Hhd, Gs, Gs
Hhd^Fdw, Hhd, Hhd, Gs, Gs, Ww, Wo, Ww, Gs, Gs, Gs, Gd, Gs, Gs, Gs, Gs, Hhd, Gs, Gs, Gs, Gs, Gs, Gs, Ce, Ce, Ce, Gs, Wwf, Gs, Gs, Gs, Gs, Wwf, Wwrg, Gs, Gd, Hhd, Hhd, Hhd, Hhd, Hhd, Hhd, Hhd, Hhd, Gs, Gs
Hhd^Fdw, Hhd, Hhd, Gs, Gs, Ww, Wo, Ww, Gs, Gs, Gs, Gs, Gs, Gs, Gs, Hhd, Hhd, Hhd, Hhd, Gs, Gs, Gs, Gs, Gs, Gs, Gs, Gd, Wwf, Wwf, Wwf, Wwf, Gs, Wwrg, Gs, Gs, Gs, Hhd, Hhd, Hhd, Hhd, Hhd, Hhd, Hhd, Hhd, Gs, Gs
Hhd^Fdw, Hhd^Fdw, Hhd, Hhd, Gs, Ww, Wo, Ww, Ww, Gs, Gs, Gs, Gs, Gs, Gs, Hhd, Hhd^Fdw, Hhd, Hhd, Gs, Hhd, Gs, Gs, Gs, Gs, Gs, Gs, Gs, Gs, Wwf, Gs, Ww, Ww, Wwrg, Gs, Gs, Gs, Hhd, Hhd, Hhd, Hhd, Hhd, Hhd, Hhd, Gs, Gs
Hhd^Fdw, Hhd^Fdw, Hhd, Hhd, Gs, Ww, Ww, Wo, Wo, Ww, Ww, Gs, Gs, Gs, Gs, Hhd, Hhd, Hhd^Fdw, Hhd^Fdw, Hhd, Hhd^Fdw, Hhd, Hhd, Gs, Gs, Gs, Gs, Gs, Gs, Gd^Vo, Wwrg, Ww, Ww, Ww, Gs, Gs, Gs, Gs, Gs, Gll, Gs, Hhd, Gs, Gs, Gs, Gs
Hhd^Fdw, Hhd^Fdw, Hhd, Hhd, Gs, Gs, Gs, Ww, Ww, Wo, Ww, Gs, Gs, Gs, Gs, Hhd, Hhd, Hhd^Fdw, Hhd^Fdw, Hhd^Fdw, Hhd^Fdw, Hhd^Fdw, Hhd, Hhd, Gs, Gs, Gs, Gs, Gs, Wwrg, Gs, Ww, Gs, Gs, Gll^Fdw, Gll, Gll, Gll, Gll^Fdw, Gll, Gll, Gll, Gll, Gs, Gs, Gs
Hhd^Fdw, Hhd^Fdw, Hhd, Gs, Gs, Gs, Gs, Ww, Ww, Wo, Wo, Ww, Ww, Gs, Gs, Hhd, Hhd, Hhd, Hhd, Hhd^Fdw, Hhd^Fdw, Hhd^Fdw, Hhd^Fdw, Hhd, Hhd, Gs, Hhd^Fdw, Gll^Fdw, Wwrg, Wwf, Gll^Fdw, Gs, Gll^Fdw, Gll^Fdw, Gll^Fdw, Gll^Fdw, Gll^Fdw, Gll^Fdw, Gll^Fdw, Gll^Fdw, Gll^Fdw, Gs, Gll^Fdw, Gll, Gs, Gs
Hhd, Hhd^Fdw, Hhd, Gs, Gs, Gs, Gs, Gs, Gs, Ww, Ww, Wo, Ww, Gs, Gs, Gs, Gs, Hhd, Hhd, Hhd^Fdw, Hhd^Fdw, Hhd^Fdw, Hhd^Fdw, Hhd^Fdw, Hhd^Fdw, Hhd, Hhd^Fdw, Hhd^Fdw, Wwrg, Gll^Fdw, Gll^Fdw, Gll^Fdw, Hhd^Fdw, Hhd^Fdw, Hhd^Fdw, Gll^Fdw, Hhd^Fdw, Hhd^Fdw, Hhd^Fdw, Hhd^Fdw, Hhd^Fdw, Gll^Fdw, Gll^Fdw, Gll^Fdw, Gs, Gs
Hhd, Hhd, Hhd, Gs, Gs, Gs, Gd^Vo, Gs, Gs, Ww, Ww, Wo, Wo, Ww, Ww, Gs, Gs, Gs, Gs, Hhd, Hhd, Hhd, Hhd, Hhd^Fdw, Hhd^Fdw, Hhd^Fdw, Hhd^Fdw, Hhd^Fdw, Gll, Ww, Hhd^Fdw, Hhd^Fdw, Hhd^Fdw, Hhd^Fdw, Hhd^Fdw, Hhd^Fdw, Hhd^Fdw, Hhd^Fdw, Hhd^Fdw, Hhd^Fdw, Hhd^Fdw, Hhd^Fdw, Gll^Fdw, Gll^Fdw, Gll^Fdw, Gs
Hhd, Hhd, Gs, Gs, Gs, Gs, Gs, Gs, Gs, Gs, Gs, Ww, Ww, Wo, Ww, Gs, Gs, Gs, Gs, Gs, Gs, Hhd, Hhd, Hhd, Hhd, Hhd, Ww, Gll, Wwrg, Ww, Hhd^Fdw, Hhd^Fdw, Hhd^Fdw, Hhd^Fdw, Hhd^Fdw, Hhd^Fdw, Hhd^Fdw, Hhd^Fdw, Hhd^Fdw, Hhd^Fdw, Hhd^Fdw, Hhd^Fdw, Hhd^Fdw, Gll^Fdw, Gll^Fdw, Gs
Gs, Gs, Gs, Gs, Gs, Gs, Gs, Gs, Gs, Gs, Gs, Gs, Ww, Wo, Wo, Ww, Ww, Gs, Gs, Gs, Gs, Gs, Gs, Hhd, Wwrg, Wwrg, Re^Gvs, Ww, Gs, Gll^Fdw, Gll^Fdw, Hhd^Fdw, Hhd^Fdw, Hhd^Fdw, Hhd^Fdw, Hhd^Fdw, Hhd^Fdw, Hhd^Fdw, Hhd^Fdw, Hhd^Fdw, Hhd^Fdw, Hhd^Fdw, Hhd^Fdw, Gll^Fdw, Gll, Gs
Gs, Gs, Gs, Gs, Hhd, Gs, Hhd, Gs, Gs, Gs, Gs, Gs, Gll^Fdw, Ww, Ww, Wo, Ww, Gs, Gs, Gd^Vo, Gs, Gs, Ww, Ww, Gs, Re^Gvs, Re^Gvs, Re^Gvs, Gll, Gll^Fdw, Gll^Fdw, Hhd^Fdw, Hhd^Fdw, Hhd^Fdw, Gll^Fdw, Gll^Fdw, Gll^Fdw, Hhd^Fdw, Hhd^Fdw, Hhd^Fdw, Hhd^Fdw, Hhd^Fdw, Hhd^Fdw, Gll^Fdw, Gll, Gs
Gs, Gs, Gs, Hhd, Hhd, Hhd, Hhd^Fdw, Hhd, Hhd, Gs, Gll^Fdw, Gll^Fdw, Gll^Fdw, Gll^Fdw, Ww, Ww, Ww, Gs, Gs, Gs, Wwf, Wwf, Re^Gvs, Re^Gvs, Re^Gvs, Gs, Gd^Vo, Gll, Gs, Gll^Fdw, Gll^Fdw, Hhd^Fdw, Hhd^Fdw, Hhd^Fdw, Gll^Fdw, Gll^Fdw, Gll^Fdw, Hhd^Fdw, Hhd^Fdw, Hhd^Fdw, Hhd^Fdw, Hhd^Fdw, Hhd^Fdw, Gll^Fdw, Gll^Fdw, Gs
Gs, Gs, Gll^Fdw, Hhd, Hhd, Hhd, Hhd^Fdw, Hhd^Fdw, Hhd^Fdw, Hhd, Hhd, Hhd, Hhd, Gll^Fdw, Gll^Fdw, Ww, Wo, Ww, Ww, Ss, Ww, Wwf, Gs, Re^Gvs, Gs, Gs, Gs, Gll, Gll, Gll^Fdw, Gs, Gll^Fdw, Gll^Fdw, Gll^Fdw, Gll, Gll, Gll^Fdw, Gll^Fdw, Hhd^Fdw, Hhd^Fdw, Hhd^Fdw, Hhd^Fdw, Gll^Fdw, Gll^Fdw, Gs, Gs
Gs, Gs, Gll^Fdw, Gll^Fdw, Hhd, Hhd, Hhd^Fdw, Hhd^Fdw, Hhd, Hhd, Hhd, Hhd, Hhd, Gll^Fdw, Gll^Fdw, Ww, Ww, Wo, Wo, Ww, Ww, Ww, Gs, Gs, Gs, Gs, Gll, Gs, Gs, Gs, Co, Co, Co, Gs, Gll, Gd^Vo, Gll^Fdw, Gll^Fdw, Hhd^Fdw, Hhd^Fdw, Hhd^Fdw, Hhd^Fdw, Gll^Fdw, Gll^Fdw, Gs, Gs
Gs, Gs, Gll^Fdw, Gll^Fdw, Gll^Fdw, Hhd, Hhd, Hhd, Hhd, Hhd, Hhd, Hhd, Hhd, Hhd, Gll^Fdw, Gll^Fdw, Gll^Fdw, Ww, Ww, Wo, Ww, Gs, Gs, Gs, Gd^Vo, Gll, Gs, Gs, Gs, Gll, Co, Co, 5 Ko, Co, Gs, Gll^Fdw, Gll^Fdw, Hhd^Fdw, Hhd^Fdw, Hhd^Fdw, Hhd^Fdw, Hhd^Fdw, Gll^Fdw, Gll^Fdw, Gs, Gs
Gs, Gs, Gs, Gll^Fdw, Gll^Fdw, Gll^Fdw, Hhd, Hhd, Hhd, Hhd, Hhd, Hhd, Hhd, Hhd, Gll^Fdw, Gll^Fdw, Gll^Fdw, Gll^Fdw, Ww, Wo, Ww, Gs, Gs, Gs, Gll, Gs, Gll^Fdw, Gll^Fdw, Gll^Fdw, Gll^Fdw, Co, Co, Co, Co, Gll^Fdw, Gll^Fdw, Hhd^Fdw, Hhd^Fdw, Hhd^Fdw, Hhd^Fdw, Hhd^Fdw, Hhd^Fdw, Gll^Fdw, Gll^Fdw, Gs, Gs
Gs, Gs, Gs, Gll^Fdw, Gll^Fdw, Gll^Fdw, Gll^Fdw, Hhd, Hhd, Hhd, Hhd^Fdw, Hhd, Hhd, Hhd, Gll^Fdw, Gll^Fdw, Gll^Fdw, Gll^Fdw, Ww, Wo, Ww, Gs, Gs, Gs, Gll, Gs, Gll^Fdw, Gll^Fdw, Gll^Fdw, Gll^Fdw, Gll^Fdw, Co, Gll^Fdw, Gll^Fdw, Hhd^Fdw, Hhd^Fdw, Hhd^Fdw, Hhd^Fdw, Hhd^Fdw, Hhd^Fdw, Hhd^Fdw, Gll^Fdw, Gs, Gs, Gs, Gs
Gs, Gs, Gll^Fdw, Gll^Fdw, Gll^Fdw, Gll^Fdw, Hhd, Hhd, Hhd^Fdw, Hhd^Fdw, Hhd^Fdw, Hhd^Fdw, Hhd, Hhd, Gll^Fdw, Gd^Vo, Gll^Fdw, Gll^Fdw, Ww, Ww, Ww, Gs, Gs, Gll, Gll, Gll^Fdw, Gll^Fdw, Gll^Fdw, Gll^Fdw, Gll^Fdw, Gll^Fdw, Gll^Fdw, Hhd^Fdw, Hhd^Fdw, Hhd^Fdw, Hhd^Fdw, Hhd^Fdw, Hhd^Fdw, Hhd^Fdw, Hhd^Fdw, Gll^Fdw, Gll^Fdw, Gs, Gs, Gs, Gs
Gll^Fdw, Gll^Fdw, Gll^Fdw, Gll^Fdw, Gll^Fdw, Gll^Fdw, Hhd, Hhd^Fdw, Hhd^Fdw, Hhd^Fdw, Hhd^Fdw, Hhd^Fdw, Hhd, Gll^Fdw, Gll^Fdw, Gll^Fdw, Gll^Fdw, Gll^Fdw, Ww, Ww, Ww, Gs, Gs, Gs, Gs, Gll^Fdw, Hhd^Fdw, Hhd^Fdw, Hhd^Fdw, Hhd^Fdw, Hhd^Fdw, Hhd^Fdw, Hhd^Fdw, Hhd^Fdw, Hhd^Fdw, Hhd^Fdw, Hhd^Fdw, Hhd^Fdw, Hhd^Fdw, Hhd^Fdw, Gll^Fdw, Gs, Gs, Gs, Gs, Gs
Gll^Fdw, Gll^Fdw, Gll^Fdw, Gll^Fdw, Hhd, Hhd, Hhd, Hhd, Hhd, Hhd, Hhd, Hhd, Hhd, Gll^Fdw, Gll^Fdw, Gll^Fdw, Gll^Fdw, Gll^Fdw, Wwf, Ww, Ww, Gs, Gs, Gs, Gs, Gll^Fdw, Gll^Fdw, Hhd^Fdw, Hhd^Fdw, Hhd^Fdw, Hhd^Fdw, Hhd^Fdw, Hhd^Fdw, Hhd^Fdw, Hhd^Fdw, Hhd^Fdw, Hhd^Fdw, Gll^Fdw, Gll^Fdw, Gll^Fdw, Gs, Gs, Gd, Gs, Gs, Gs
Gll^Fdw, Gll^Fdw, Gll^Fdw, Gll^Fdw, Hhd, Hhd, Hhd, Hhd, Co, Hhd, Hhd, Hhd, Gll^Fdw, Gll^Fdw, Gll^Fdw, Gll^Fdw, Ww, Wwf, Wwf, Wwf, Wwf, Gs, Gs, Gs, Gs, Gll, Gll^Fdw, Hhd^Fdw, Gll^Fdw, Hhd^Fdw, Gll^Fdw, Hhd^Fdw, Hhd^Fdw, Hhd^Fdw, Gll^Fdw, Hhd^Fdw, Gll^Fdw, Gll^Fdw, Gs, Gs, Gs, Gs, Gs, Gd, Gs, Gs
Gll^Fdw, Gll^Fdw, Gll^Fdw, Gll^Fdw, Gll^Fdw, Hhd, Hhd, Hhd, Co, Co, Co, Gll^Fdw, Gll^Fdw, Gll^Fdw, Gll^Fdw, Gll^Fdw, Ww, Ww, Ww, Wwf, Gd^Vo, Gs, Gs, Gs, Gll^Fdw, Gll, Gll, Gll^Fdw, Gll, Gll^Fdw, Gll^Fdw, Gll^Fdw, Gll^Fdw, Gll^Fdw, Gs, Gll^Fdw, Gs, Gs, Gs, Gs, Hhd, Gs, Gs, Gd^Vo, Gs, Gs
Gs, Gs, Gll^Fdw, Gll^Fdw, Gd^Vo, Hhd, Gs, Co, Co, 4 Ko, Co, Gll^Fdw, Gll^Fdw, Gll^Fdw, Gll^Fdw, Ww, Ww, Ww, Ww, Ww, Gll^Fdw, Gs, Gll^Fdw, Gll^Fdw, Gll^Fdw, Gll^Fdw, Gll^Fdw, Gll, Gs, Gll, Gll, Gs, Gll, Gs, Gs, Gs, Gs, Gs, Hhd, Hhd, Hhd, Hhd, Gs, Gs, Gs, Gs
Gs, Gs, Gs, Gll^Fdw, Re^Gvs, Re^Gvs, Gs, Gs, Gd, Co, Gll, Gll^Fdw, Gll^Fdw, Gll^Fdw, Ww, Ww, Ww, Ww, Gll^Fdw, Gll^Fdw, Gll^Fdw, Gll^Fdw, Hhd, Gll^Fdw, Hhd, Hhd, Hhd, Gll^Fdw, Gll, Gs, Hhd, Gll, Gs, Gs, Gs, Gd, Gs, Hhd, Hhd, Hhd, Hhd, Hhd, Gs, Gd, Gd, Gs
Gs, Gs, Gs, Gs, Re^Gvs, Re^Gvs, Gs, Gs, Gs, Gs, Gs, Gs, Gs, Gd^Vo, Ww, Ww, Ww, Ww, Gll^Fdw, Gll^Fdw, Hhd, Hhd, Hhd, Hhd, Hhd, Hhd, Hhd, Gll, Gs, Hhd, Hhd, Hhd, Gs, Gs, Gs, Gs, Hhd, Hhd, Hhd, Hhd, Gs, Gs, Re^Gvs, Gs, Gs, Gs
Gs, Gs, Gd, Gd^Vo, Gs, Gs, Hhd, Hhd, Hhd, Gs, Gs, Gs, Gs, Gll, Ww, Ww, Ww, Gll^Fdw, Gll^Fdw, Hhd, Hhd, Hhd, Hhd, Hhd^Fdw, Hhd, Hhd, Gs, Gs, Hhd, Hhd, Hhd^Fdw, Hhd, Gs, Gd, Gs, Hhd, Hhd, Hhd, Hhd, Gs, Re^Gvs, Re^Gvs, Re^Gvs, Re^Gvs, Re^Gvs, Gs
Gs, Gs, Gs, Gs, Hhd, Hhd, Hhd, Hhd, Hhd, Gs, Gd^Vo, Gs, Gs, Gs, Ww, Wo, Ww, Gll^Fdw, Hhd, Hhd, Hhd, Hhd, Hhd^Fdw, Hhd^Fdw, Hhd, Hhd, Gs, Gll, Hhd, Hhd^Fdw, Hhd^Fdw, Hhd, Gs, Gd, Hhd, Hhd, Hhd, Hhd, Hhd, Gs, Gs, Re^Gvs, Re^Gvs, Re^Gvs, Gs, Gs
Gs, Gd, Gs, Hhd, Hhd, Hhd, Hhd, Hhd, Hhd, Gs, Gs, Re^Gvs, Gs, Gs, Ww, Wo, Ww, Gll^Fdw, Hhd, Hhd, Hhd, Hhd, Hhd^Fdw, Hhd^Fdw, Hhd, Hhd, Gs, Gs, Hhd, Hhd, Hhd, Hhd, Gs, Gs, Hhd, Hhd, Hhd, Hhd, Hhd, Gs, Gs, Gs, Gs, Gd, Gs, Gs
Gs, Gs, Gs, Hhd, Hhd, Hhd, Hhd^Fdw, Hhd, Hhd, Hhd, Gs, Gd, Gs, Gs, Ww, Wo, Ww, Gll^Fdw, Gll^Fdw, Hhd, Hhd, Hhd, Hhd, Hhd^Fdw, Hhd, Gs, Gs, Gs, Gs, Hhd, Gs, Gs, Gs, Gd^Vo, Hhd, Hhd, Hhd, Hhd, Hhd, Hhd, Hhd, Gs, Gs, Gd, Gs, Gs
Gs, Gs, Hhd, Hhd, Hhd, Hhd, Hhd^Fdw, Hhd, Hhd, Hhd, Gs, Gs, Gs, Gs, Ww, Ww, Wwf, Gll^Fdw, Gll^Fdw, Gll^Fdw, Hhd, Hhd, Hhd, Hhd, Hhd, Hhd, Hhd, Gs, Gs, Gs, Gs, Gs, Gs, Hhd, Hhd, Hhd, Hhd^Fdw, Hhd^Fdw, Hhd^Fdw, Hhd, Hhd, Gs, Gs, Gs, Gs, Gs
Gs, Gs, Hhd, Hhd, Hhd, Hhd^Fdw, Hhd^Fdw, Hhd, Hhd, Hhd, Gll, Gs, Gs, Gd^Vo, Wwf, Wwf, Ww, Gll^Fdw, Gll^Fdw, Gll^Fdw, Gll^Fdw, Hhd, Gll^Fdw, Hhd, Hhd, Hhd, Hhd, Hhd, Hhd, Gs, Gs, Gd, Gs, Hhd, Hhd, Hhd, Hhd^Fdw, Hhd^Fdw, Hhd^Fdw, Hhd, Hhd, Gs, Gs, Gs, Gs, Gs
Gs, Gs, Gs, Hhd, Hhd, Hhd^Fdw, Hhd^Fdw, Hhd, Hhd, Hhd, Gll^Fdw, Gll, Gll, Gs, Ww, Ww, Wo, Ww, Ww, Gll^Fdw, Gll^Fdw, Gll^Fdw, Gll^Fdw, Gll^Fdw, Gll^Fdw, Hhd, Hhd, Hhd, Hhd, Gll^Fdw, Gs, Gs, Gs, Hhd, Hhd, Hhd, Hhd^Fdw, Hhd^Fdw, Hhd^Fdw, Hhd, Hhd, Hhd, Gs, Gs, Gs, Gs
Gs, Gs, Gs, Hhd, Hhd, Hhd, Hhd^Fdw, Hhd^Fdw, Hhd, Hhd, Gll^Fdw, Gll^Fdw, Gll^Fdw, Gs, Gll, Ww, Ww, Wo, Wo, Ww, Ww, Gll^Fdw, Gll, Gll^Fdw, Gll^Fdw, Gll^Fdw, Gll^Fdw, Hhd, Gll^Fdw, Gll^Fdw, Gs, Gs, Gs, Gs, Hhd, Hhd, Hhd, Hhd, Hhd, Hhd, Hhd, Hhd, Gs, Gs, Gs, Gs
Gs, Gs, Gs, Hhd, Hhd, Hhd, Hhd, Hhd^Fdw, Hhd, Hhd, Gll^Fdw, Gll^Fdw, Gll^Fdw, Gll, Gs, Gs, Gs, Ww, Ww, Ww, Ww, Ww, Ww, Gll, Gll, Gll^Fdw, Gll^Fdw, Gll^Fdw, Gll^Fdw, Gll^Fdw, Gs, Gd^Vo, Gs, Gs, Gs, Hhd, Hhd, Hhd, Hhd, Hhd, Hhd, Gs, Gs, Gd^Vo, Gs, Gs
Gs, Gs, Gs, Gs, Hhd, Hhd, Hhd, Hhd, Hhd, Hhd, Hhd, Gll^Fdw, Gll^Fdw, Gs, Gs, Gs, Gd, Gs, Gs, Ww, Ww, Wo, Wwf, Wwf, Ww, Gll, Gll, Gll, Gll, Gs, Gs, Gs, Gs, Gs, Gs, Gs, Gs, Hhd, Hhd, Hhd, Hhd, Gs, Gd, Gs, Gs, Gs
Gs, Gs, Gd, Gs, Gs, Hhd, Hhd, Hhd, Hhd, Hhd, Hhd, Hhd, Hhd, Gll, Gs, Gs, Gd, Gs, Gs, Ww, Ww, Ww, Wwf, Wo, Wo, Ww, Ww, Gll, Gs, Gs, Gs, Gs, Co, Co, Co, Gs, Gs, Gs, Gs, Hhd, Gs, Gs, Gs, Gs, Gs, Gs
Gs, Gs, Gd^Vo, Gs, Gs, Gs, Gs, Hhd, Hhd, Hhd^Fdw, Hhd^Fdw, Hhd, Hhd, Hhd, Hhd, Gs, Gs, Gd, Gd^Vo, Gs, Gll, Gll, Gll, Ww, Ww, Wo, Ww, Ww, Gs, Gs, Gs, Gs, Co, Co, 3 Ko, Co, Gs, Gs, Gd^Vo, Gs, Gs, Gd, Gs, Gs, Gs, Gs
Gs, Gs, Re^Gvs, Re^Gvs, Gs, Gs, Gs, Hhd, Hhd, Hhd, Hhd, Hhd^Fdw, Hhd^Fdw, Hhd, Hhd, Hhd, Hhd, Gs, Gs, Gs, Gs, Gll, Gll, Gll, Gll, Ww, Ww, Ww, Ww, Gs, Gs, Gs, Gs, Co, Co, Co, Gs, Gs, Gs, Gs, Gs, Gs, Gs, Gs, Gs, Gs
Gs, Gs, Gs, Gs, Gs, Gs, Gll^Fdw, Gll^Fdw, Gll^Fdw, Hhd, Hhd, Hhd, Hhd, Hhd^Fdw, Hhd^Fdw, Hhd, Hhd, Gs, Gs, Gs, Gll^Fdw, Gll^Fdw, Gll^Fdw, Gll, Gll, Ww, Ww, Ww, Wwf, Wwf, Ww, Gs, Gs, Gs, Gs, Gd, Gs, Gs, Gs, Gd, Gs, Gs, Gs, Gd, Gs, Gs
Gs, Gs, Gs, Gs, Gs, Gs, Gs, Gll^Fdw, Gll^Fdw, Gll^Fdw, Hhd, Hhd, Hhd, Hhd^Fdw, Hhd, Hhd, Hhd, Gs, Gd, Gs, Gll^Fdw, Gll^Fdw, Gll^Fdw, Gll^Fdw, Gs, Gll, Gs, Wwf, Ww, Ww, Ww, Ww, Ww, Gs, Gs, Gs, Gs, Gs, Gs, Gd, Gs, Gs, Gs, Gd, Gs, Gs
Gs, Gs, Gs, Gs, Gs, Gs, Gs, Gll^Fdw, Hhd, Hhd, Hhd, Hhd, Hhd^Fdw, Hhd^Fdw, Hhd, Hhd, Hhd, Gs, Gs, Gs, Gll^Fdw, Gll^Fdw, Hhd, Hhd, Hhd, Gs, Gs, Gs, Gd^Vo, Ww, Wo, Wo, Ww, Ww, Ww, Gs, Gs, Gs, Gs, Gs, Gd^Vo, Gs, Gs, Gs, Gs, Gs
Gs, Gs, Gd, Gs, Gs, Gs, Gs, Gs, Hhd, Hhd, Hhd, Hhd, Hhd, Hhd, Hhd, Hhd, Gs, Gs, Gs, Gs, Hhd, Hhd, Hhd, Hhd, Hhd, Gs, Gs, Gs, Gs, Ww, Ww, Wo, Ww, Wo, Wo, Ww, Ww, Gs, Gs, Gs, Gs, Gs, Gs, Gs, Gs, Gs
Gs, Gs, Gs, Gd, Gd, Gs, Gs, Gs, Gs, Hhd, Hhd, Hhd, Hhd, Hhd, Hhd, Hhd, Gll, Gs, Hhd, Hhd, Hhd^Fdw, Hhd^Fdw, Hhd^Fdw, Hhd, Hhd, Gs, Gs, Gs, Gs, Gs, Gs, Ww, Gs, Ww, Ww, Ww, Ww, Ww, Gs, Gs, Gs, Gs, Gs, Gs, Gs, Gs
Gs, Gs, Gs, Gs, Gs, Gd^Vo, Re^Gvs, Gs, Gs, Hhd, Hhd, Hhd, Hhd, Hhd, Gll^Fdw, Gll^Fdw, Gll, Gll, Hhd, Hhd, Hhd^Fdw, Hhd^Fdw, Hhd^Fdw, Hhd^Fdw, Hhd, Hhd, Gs, Gs, Gll, Gs, Gs, Gs, Gs, Gs, Gs, Ww, Wwf, Wwf, Ww, Gs, Gs, Gd, Gd, Gs, Gs, Gs
Gll^Fdw, Gs, Gs, Gs, Gs, Re^Gvs, Gs, Gs, Gs, Gs, Hhd, Hhd, Hhd, Hhd, Gll^Fdw, Gs, Gs, Gs, Hhd, Hhd, Hhd, Hhd, Hhd, Hhd, Hhd, Hhd, Gll, Gll, Gll^Fdw, Gll^Fdw, Gll^Fdw, Gs, Gs, Gs, Gs, Wwf, Ww, Ww, Ww, Gs, Gs, Gs, Gd^Vo, Gs, Gs, Gs
Gll^Fdw, Gll^Fdw, Gll^Fdw, Gs, Gs, Gs, Gs, Gd, Gs, Gs, Gll^Fdw, Hhd, Gll^Fdw, Gll^Fdw, Gll^Fdw, Gs, Gs, Gs, Gs, Hhd, Gd^Vo, Hhd, Gs, Gs, Gs, Gs, Gll, Gll^Fdw, Hhd, Hhd, Hhd, Gll^Fdw, Gs, Gs, Gs, Gd^Vo, Ww, Ww, Ww, Gs, Gs, Gs, Gs, Gs, Gs, Gs
Gll^Fdw, Gll^Fdw, Gll^Fdw, Gs, Gs, Gs, Gs, Gs, Gs, Gs, Gll, Gll^Fdw, Gll^Fdw, Gll^Fdw, Gs, Gs, Gs, Gs, Gs, Gs, Gs, Gs, Gs, Gs, Gd^Vo, Gll, Gll^Fdw, Gll^Fdw, Hhd, Hhd, Hhd, Gll^Fdw, Gll^Fdw, Gs, Gs, Gs, Ww, Wo, Ww, Ww, Gs, Gs, Gs, Gd, Gs, Gs
Gll^Fdw, Gll^Fdw, Gll^Fdw, Gll^Fdw, Gll^Fdw, Gs, Gs, Gs, Gll, Gll, Gs, Gs, Gs, Gll, Gs, Gll, Gd^Vo, Gs, Gd, Gs, Gd, Gd, Gd, Gs, Gs, Gs, Gll^Fdw, Hhd, Hhd, Hhd, Hhd, Hhd, Hhd, Gll^Fdw, Gs, Gs, Ww, Wo, Wo, Ww, Gs, Gs, Gs, Gs, Gs, Gs
Gll^Fdw, Gll^Fdw, Gll^Fdw, Gll^Fdw, Gll^Fdw, Gll^Fdw, Gll^Fdw, Gs, Gll, Gs, Gs, Gs, Gll, Gll, Gll, Gll, Gs, Gs, Gs, Gd, Co, Co, Co, Gs, Gs, Gs, Gll^Fdw, Hhd, Hhd, Hhd, Hhd, Hhd, Hhd, Gll^Fdw, Gll^Fdw, Gs, Gs, Ww, Ww^Bw/, Ww^Bw/, Ww, Gs, Gs, Gs, Gs, Gs
Gll^Fdw, Gll^Fdw, Gll^Fdw, Gll^Fdw, Hhd^Fdw, Gll^Fdw, Hhd^Fdw, Gll^Fdw, Gll^Fdw, Gll, Gs, Gll, Gs, Gs, Gs, Gll, Gs, Gs, Gs, Co, Co, Co, Co, Co, Gs, Gs, Gs, Gll^Fdw, Gll^Fdw, Hhd, Hhd, Hhd, Hhd, Hhd, Gll^Fdw, Gs, Gs, Gs, Ww, Wo, Wo, Ww, Gs, Gs, Gs, Gs
Hhd^Fdw, Gll^Fdw, Hhd^Fdw, Hhd^Fdw, Hhd^Fdw, Hhd^Fdw, Hhd^Fdw, Hhd^Fdw, Hhd^Fdw, Gll^Fdw, Gll^Fdw, Gll^Fdw, Gll^Fdw, Gs, Gs, Gll, Gs, Gs, Gs, Co, Co, 2 Ko, Co, Co, Gs, Gs, Re^Gvs, Gs, Gll^Fdw, Hhd, Hhd, Hhd, Hhd, Hhd, Hhd, Gll^Fdw, Gll^Fdw, Gs, Gs, Ww, Ww, Ww, Ww, Gs, Gs, Gs
Hhd^Fdw, Hhd^Fdw, Hhd^Fdw, Hhd^Fdw, Hhd^Fdw, Hhd^Fdw, Hhd^Fdw, Hhd^Fdw, Hhd^Fdw, Hhd^Fdw, Hhd^Fdw, Hhd^Fdw, Hhd^Fdw, Gll^Fdw, Gll^Fdw, Gll^Fdw, Gll^Fdw, Gs, Gs, Gs, Gs, Co, Gs, Gs, Gd, Re^Gvs, Re^Gvs, Gs, Gll^Fdw, Gll^Fdw, Hhd, Hhd, Hhd^Fdw, Hhd, Hhd, Hhd, Gll^Fdw, Gs, Gs, Gs, Ww, Wo, Ww, Gs, Gs, Gs
Hhd^Fdw, Hhd^Fdw, Hhd^Fdw, Hhd^Fdw, Hhd^Fdw, Hhd^Fdw, Hhd^Fdw, Hhd^Fdw, Hhd^Fdw, Hhd^Fdw, Hhd^Fdw, Hhd^Fdw, Hhd^Fdw, Gll^Fdw, Hhd^Fdw, Gll^Fdw, Gll^Fdw, Gll^Fdw, Gd^Vo, Gs, Gs, Gs, Gs, Gs, Gd^Vo, Gs, Gs, Gs, Gs, Gll^Fdw, Hhd, Hhd, Hhd^Fdw, Hhd^Fdw, Hhd^Fdw, Hhd, Hhd, Gll^Fdw, Gs, Gs, Gs, Ww, Wo, Ww, Gs, Gs
Hhd^Fdw, Hhd^Fdw, Hhd^Fdw, Hhd^Fdw, Hhd^Fdw, Hhd^Fdw, Hhd^Fdw, Hhd^Fdw, Hhd^Fdw, Hhd^Fdw, Hhd^Fdw, Hhd^Fdw, Hhd^Fdw, Hhd^Fdw, Hhd^Fdw, Hhd^Fdw, Hhd^Fdw, Gll^Fdw, Gll^Fdw, Gs, Gs, Gs, Gd, Gs, Gs, Gs, Gs, Gs, Gs, Gll^Fdw, Hhd, Hhd, Hhd^Fdw, Hhd^Fdw, Hhd^Fdw, Hhd, Hhd, Gll^Fdw, Gll^Fdw, Gs, Gs, Ww, Wo, Ww, Ww, Gs
Hhd^Fdw, Hhd^Fdw, Hhd^Fdw, Hhd^Fdw, Hhd^Fdw, Hhd^Fdw, Hhd^Fdw, Hhd^Fdw, Hhd^Fdw, Hhd^Fdw, Hhd^Fdw, Hhd^Fdw, Hhd^Fdw, Hhd^Fdw, Hhd^Fdw, Hhd^Fdw, Hhd^Fdw, Hhd^Fdw, Hhd^Fdw, Gll^Fdw, Gs, Gs, Gs, Gs, Gd, Gs, Gd, Gs, Gs, Gll^Fdw, Gll^Fdw, Hhd, Hhd, Hhd^Fdw, Hhd^Fdw, Hhd^Fdw, Hhd, Hhd, Gll^Fdw, Gs, Gs, Ww, Ww, Wo, Ww, Gs
Gs, Hhd^Fdw, Hhd^Fdw, Hhd^Fdw, Hhd, Hhd, Hhd, Hhd^Fdw, Hhd^Fdw, Hhd^Fdw, Gs, Hhd^Fdw, Hhd^Fdw, Hhd^Fdw, Hhd^Fdw, Hhd^Fdw, Hhd^Fdw, Hhd^Fdw, Hhd^Fdw, Gll^Fdw, Gs, Gs, Gs, Gs, Gs, Gs, Gs, Gs, Gs, Gs, Gll^Fdw, Hhd, Hhd, Hhd^Fdw, Hhd^Fdw, Hhd^Fdw, Hhd, Hhd, Gs, Gs, Gs, Gs, Ww, Wo, Ww, Gs
