Mm, Mm, Mm, Mm, Mm, Mm, Mm, Mm, Mm, Mm, Mm, Mm, Mm, Mm, Mm, Mm, Mm, Mm, Mm, Mm, Mm, Gg, Ha^Fpa, Gd, Aa^Fpa, Ha^Fpa, Mm, Mm, Mm, Mm, Mm, Mm, Mm, Ai, Ms, Mm, Mm, Mm, Mm, Mm, Mm, Mm, Mm, Mm, Mm, Mm, Mm, Mm, Mm, Mm, Mm
Mm, Mm, Mm, Mm, Mm, Mm, Mm, Mm, Mm, Mm, Mm, Mm, Mm, Mm, Mm, Mm, Mm, Mm, Mm, Mm, Mm, Mm, Ha^Fpa, Aa, Aa^Fpa, Ha^Fpa, Mm, Mm, Ms, Mm, Mm, Mm, Mm, Ai, Mm, Ms, Mm, Mm, Mm, Mm, Mm, Mm, Ms, Mm, Mm, Mm, Mm, Mm, Mm, Mm, Mm
Mm, Mm, Mm, Mm, Mm, Ms, Ms, Mm, Mm, Mm, Ms, Mm, Mm, Mm, Ms, Ms, Ms, Mm, Mm, Mm, Mm, Mm, Ha^Fpa, Aa, Ha^Fpa, Ha^Fpa, Mm, Mm, Mm, Ms, Mm, Mm, Mm, Ai, Ai, Mm, Ai, Ms, Ms, Mm, Mm, Mm, Mm, Mm, Mm, Mm, Mm, Ms, Mm, Mm, Mm
Mm, Mm, Mm, Mm, Mm, Mm, Mm, Mm, Mm, Mm, Ms, Mm, Mm, Mm, Mm, Mm, Mm, Mm, Mm, Mm, Ha^Fpa, Ha^Fpa, Aa, Aa^Fpa, Ha^Fpa, Mm, Ms, Mm, Mm, Mm, Mm, Mm, Mm, Ai, Ai, Ai, Wwg, Ai, Ai, Mm, Wwg, Ai, Ai, Mm, Mm, Mm, Mm, Mm, Mm, Mm, Mm
Mm, Ms, Ms, Mm, Mm, Mm, Mm, Mm, Mm, Mm, Mm, Mm, Mm, Mm, Mm, Mm, Mm, Mm, Aa^Fpa, Ha^Fpa, Aa^Fpa, Aa^Fpa, Aa, Aa^Fpa, Ha^Fpa, Mm, Ms, Mm, Mm, Mm, Mm, Mm, Mm, Mm, Mm, Ai, Ai, Wwg, Wwg, Wwg, Mm, Wwg, Ai, Wwg, Ai, Ha^Fpa, Mm, Mm, Mm, Ms, Mm
Mm, Mm, Mm, Mm, Mm, Mm, Mm, Mm, Mm, Mm, Ha^Fpa, Mm, Aa^Fpa, Aa^Fpa, Aa^Fpa, Aa^Fpa, Aa^Fpa, Aa^Fpa, Ha, Aa, Aa, Aa, Gd, Ha^Fpa, Mm, Mm, Ms, Ms, Mm, Mm, Ms, Mm, Ms, Mm, Mm, Mm, Mm, Wwg, Wwg, Mm, Mm, Ms, Mm, Wwg, Wwg, Ai, Ai, Mm, Mm, Mm, Mm
Mm, Mm, Mm, Mm, Ms, Ms, Ms, Ha^Vws, Ha^Fpa, Ha^Fpa, Aa^Fpa, Aa^Fpa, Mm, Mm, Ms, Mm, Mm, Mm, Mm, Ha, Gd, Gd^Es, Gd, Ha^Fpa, Mm, Mm, Mm, Mm, Mm, Mm, Ms, Ms, Ms, Mm, Mm, Mm, Mm, Ai, Wwg, Mm, Mm, Ms, Mm, Mm, Mm, Wwg, Wwg, Mm, Mm, Ms, Mm
Mm, Mm, Mm, Mm, Mm, Ms, Ha^Fpa, Ha^Fpa, Aa^Fpa, Aa^Fpa, Aa^Fpa, Aa^Fpa, Mm, Mm, Mm, Ms, Ms, Mm, Mm, Ha, Gd, Aa^Vws, Gd, Ha^Fpa, Mm, Mm, Mm, Mm, Mm, Mm, Mm, Mm, Mm, Mm, Gd, Mm, Gd^Es, Ai, Wwg, Ha^Fpa, Mm, Mm, Mm, Mm, Mm, Ai, Wwg, Mm, Mm, Mm, Mm
Mm, Mm, Mm, Mm, Mm, Ha^Fpa, Aa^Fpa, Aa^Fpa, Cea, Cea, Cea, Aa^Fpa, Aa, Mm, Mm, Mm, Mm, Mm, Ha, Ha, Gd, Aa, Aa, Gd, Gd, Mm, Mm, Mm, Gd^Es, Gd, Gd, Gd, Gd, Gd^Es, Aa^Fpa, Gd, Gd^Es, Ai, Wwg, Ha^Fpa, Ha^Fpa, Mm, Mm, Mm, Mm, Mm, Ai, Wwg, Wwg, Mm, Gd
Mm, Mm, Ms, Mm, Ha^Fpa, Ha^Fpa, Aa^Fpa, Aa^Fpa, Cea, 1 Kea, Cea, Aa, Aa, Aa, Aa, Ha, Ha, Ha, Gd, Gd, Aa^Vws, Aa^Fpa, Aa^Fpa, Gd, Aa^Fpa, Gd, Gd, Gd, Aa^Fpa, Aa, Aa, Aa, Aa^Fpa, Aa^Fpa, Aa^Fpa, Gll^Fp, Gll^Fp, Wwg, Wwg, Ai, Ha^Fpa, Ha^Fpa, Ha^Fpa, Mm, Ms, Mm, Mm, Wwg, Ai, Wwg, Ai
Mm, Mm, Ms, Mm, Ha^Fpa, Aa^Fpa, Ha^Vws, Ha^Fpa, Ha^Fpa, Cea, Ha^Fpa, Aa, Ha^Fpa, Ha^Fpa, Ha^Fpa, Aa, Aa, Gd, Gd, Gd, Aa^Fpa, Aa^Fpa, Aa^Fpa, Aa^Fpa, Aa^Fpa, Gll^Fp, Gd, Aa^Fpa, Aa^Fpa, Aa^Fpa, Aa^Fpa, Aa^Fpa, Aa^Fpa, Gll^Fp, Aa^Fpa, Aa^Fpa, Gll^Fp, Aa^Fpa, Wwg, Ai, Ai, Ha^Fpa, Ha^Fpa, Mm, Ms, Mm, Mm, Mm, Mm, Wwg, Ai
Mm, Ms, Ms, Mm, Ha^Fpa, Ha^Fpa, Mm, Ms, Ms, Ha^Fpa, Ha^Fpa, Ha^Vws, Ms, Ms, Mm, Ha^Fpa, Aa, Aa, Gd, Aa, Gll^Fp, Aa^Fpa, Gll^Fp, Aa^Fpa, Aa^Fpa, Gll^Fp, Gd, Gll^Fp, Gll^Fp, Gll^Fp, Aa^Fpa, Aa^Fpa, Aa^Fpa, Aa^Fpa, Aa^Fpa, Aa^Fpa, Gll^Fp, Ai, Wwg, Ai, Ai, Ha^Fpa, Ha^Fpa, Mm, Mm, Mm, Ms, Mm, Ms, Mm, Mm
Mm, Mm, Mm, Ha^Fpa, Aa^Fpa, Ha^Fpa, Mm, Mm, Mm, Ms, Mm, Mm, Mm, Mm, Mm, Ha^Fpa, Aa^Fpa, Aa^Fpa, Gd, Gd^Es, Gd^Es, Gll^Fp, Gll^Fp, Aa^Fpa, Gd, Gd^Es, Gd^Es, Gd, Gd, Aa^Vca, Ai, Gll^Fp, Gll^Fp, Gll^Fp, Ai, Gll^Fp, Ai, Ai, Ai, Wwg, Ai, Ai, Ha^Fpa, Hhd^Fmw, Hhd^Fmw, Mm, Mm, Mm, Mm, Mm, Mm
Mm, Mm, Mm, Ha^Fpa, Aa^Fpa, Ha^Fpa, Ha^Fpa, Mm, Mm, Mm, Mm, Mm, Mm, Mm, Ha^Fpa, Ha^Fpa, Aa^Fpa, Aa^Fpa, Gd, Gd^Es, Gd, Gd, Gd, Gd, Gd, Gd, Wwg, Ai, Wwg, Ai, Wwg, Ai, Wwg, Ai, Ai, Ai, Ai, Ai, Wwg, Wwg, Wwg, Ai, Ai, Ha^Fpa, Hhd^Fmw, Hhd^Fmw, Hhd^Fmw, Mm, Mm, Mm, Mm
Mm, Mm, Ha^Fpa, Ha^Fpa, Aa^Fpa, Aa^Fpa, Aa^Fpa, Ha^Fpa, Mm, Mm, Ms, Mm, Mm, Mm, Ha^Fpa, Aa^Fpa, Aa^Fpa, Ai, Ai, Ai, Ai, Ai, Wwg, Ai, Wwg, Wwg, Ai, Wwg, Ai, Wwg, Aa^Fpa, Wwg, Ai, Wwg, Wwg, Ai, Wwg, Wwg, Wwg, Wwg, Wwg, Wwg, Ai, Ai, Hhd^Fmw, Hhd^Fmw, Hhd^Fmw, Hhd^Fmw, Hhd^Fmw, Hhd^Fmw, Hhd^Fmw
Mm, Mm, Ha^Fpa, Aa^Fpa, Aa^Fpa, Aa^Fpa, Aa^Fpa, Ha^Fpa, Ha^Fpa, Ms, Ha^Fpa, Ms, Ha^Fpa, Ha^Fpa, Aa^Fpa, Aa^Fpa, Ai, Ai, Wwg, Wwg, Wwg, Ai, Wwg, Wwg, Ai, Ai, Cw, Ai, Aa^Fpa, Aa^Fpa, Aa^Fpa, Aa^Fpa, Aa^Fpa, Ai, Ai, Wwg, Wwg, Wwg, Wwg, Wwg, Wwg, Wwg, Wwg, Ai, Gll^Fmw, Gll^Fmw, Gd, Hhd^Fmw, Gd, Hhd^Fmw, Hhd^Fmw
Ha^Fpa, Ha^Fpa, Aa^Fpa, Aa^Fpa, Aa^Fpa, Aa^Fpa, Aa^Fpa, Aa^Fpa, Aa^Fpa, Ha^Fpa, Aa^Fpa, Ha^Fpa, Aa^Fpa, Aa^Fpa, Ai, Ai, Wwg, Wwg, Cw, Cw, Cw, Cw, Mm, Mm, Mm, Cw, Mm^Xm, Cw, Cw, Aa^Fpa, Aa^Fpa, Aa^Fpa, Aa^Fpa, Ai, Ai, Wwg, Wwg, Wwg, Wwg, Wwg, Wwg, Wwg, Wwg, Ai, Gll^Fmw, Gll^Fmw, Gll^Fmw, Gd, Gd, Gd^Es, Gd
Aa^Fpa, Aa^Fpa, Aa^Fpa, Aa^Fpa, Ha^Fpa, Aa^Fpa, Aa^Fpa, Aa^Fpa, Aa^Fpa, Aa^Fpa, Aa^Fpa, Aa^Fpa, Ai, Wwg, Wwg, Wwg, Ai, Ai, Cw, Ms^Xm, Cw, Mm, Mm, Mm, Mm, Mm, Mm, Cw, Ms^Xm, Cw, Aa^Fpa, Aa^Fpa, Aa^Fpa, Ai, Ai, Ai, Wwg, Wwg, Wwg, Wwg, Wwg, Wwg, Wwg, Ai, Ai, Gll^Fmw, Gll^Fmw, Gll^Fp, Gll^Fp, Gd^Es, Gll^Fp
Ha^Fpa, Aa^Fpa, Ha^Fpa, Ha^Fpa, Ms, Ha^Fpa, Ha^Fpa, Aa^Fpa, Aa^Fpa, Aa^Fpa, Wwg, Wwg, Wwg, Wwg, Aa^Fpa, Ai, Aa^Fpa, Cw, Ms^Xm, Ms^Xm, Cw, Mm, Ms, Mm, Ms, Rrc^Vws, Ms, Cw, Ms^Xm, Ha^Vws, Cw, Aa^Fpa, Gd, Gd, Gd, Ai, Ai, Wwg, Wwg, Wwg, Wwg, Wwg, Ai, Ai, Ai, Gll^Fmw, Gll^Fmw, Gll^Fmw, Aa^Fpa, Gll^Fp, Gll^Fp
Mm, Ha^Fpa, Ms, Ms, Mm, Mm, Mm, Ha^Fpa, Aa^Fpa, Aa^Fpa, Wwg, Ai, Aa^Fpa, Aa^Fpa, Aa^Fpa, Aa^Fpa, Mm, Ha^Vws, Ms^Xm, Mm, Rrc^Vws, Cw, Ms^Xm, Ms, Ms^Xm, Ms^Xm, Ms^Xm, Cw, Ms^Xm, Ms^Xm, Cw, Cw, Gd, Gd^Es, Gd^Es, Ai, Ai, Ai, Ai, Ai, Ai, Ai, Ai, Ai, Ai, Gll^Fmw, Aa^Fpa, Aa^Fpa, Gll^Fp, Aa^Fpa, Aa^Fpa
Mm, Mm, Mm, Mm, Mm, Ms, Mm, Ha^Fpa, Wwg, Wwg, Ha^Fpa, Aa^Fpa, Mm, Aa^Fpa, Aa^Fpa, Aa^Fpa, Mm, Ms^Xm, Ms^Xm, Mm, Mm, Cw, Rrc^Vws, Ms^Xm, Ms^Xm, Ms^Xm, Mm^Xm, Cw, Rrc^Vws, Cw, Mm, Cw, Gd, Gd, Gd, Gd, Gd, Ai, Gd, Ai, Ai, Ai, Ai, Ai, Gll^Fmw, Aa^Fpa, Gd, Gll^Fp, Gll^Fp, Aa^Fpa, Gd
Mm, Mm, Mm, Mm, Mm, Mm, Ms, Ha^Fpa, Wwg, Ha^Fpa, Mm, Mm, Ms, Mm, Mm, Aa^Fpa, Mm, Mm, Mm, Mm, Mm, Cw, Cw, Ms^Xm, Ms^Xm, Ms^Xm, Cw, Cw, Cw, Cw, Mm, Mm, Gd, Gll^Fmw, Gll^Fmw, Gll^Fmw, Gll^Fmw, Gd, Gd, Gll^Fmw, Gll^Fmw, Gll^Fmw, Gll^Fmw, Gll^Fmw, Gll^Fmw, Gll^Fmw, Gd, Gd, Gd^Es, Gll^Fp, Gll^Fp
Mm, Mm, Mm, Ms, Ms, Mm, Ha^Fpa, Ha^Fpa, Wwg, Ha^Fpa, Mm, Mm, Ms, Mm, Mm, Aa^Fpa, Cw, Mm, Rrc^Vws, Mm, Rrc^Vws, Kw, Ms^Xm, Cw, 2 Kw, Cw, Ms^Xm, Kw, Cw, Ms, Mm, Mm^Xm, Gd, Gll^Fmw, Gll^Fmw, Gll^Fmw, Gll^Fmw, Gd^Es, Gll^Fp, Gll^Fmw, Gd, Gll^Fmw, Gd, Gd, Gd, Gll^Fp, Gll^Fp, Aa^Fpa, Aa^Fpa, Gd, Gll^Fp
Mm, Mm, Ha^Fpa, Ha^Fpa, Ha^Fpa, Ha^Fpa, Wwg, Wwg, Ai, Ha^Fpa, Ha^Fpa, Mm, Ms, Mm, Mm, Gll^Fmw, Cw, Cw, Cw, Cw, Cw, Cw, Cw, Cw, Cw, Cw, Cw, Cw, Rrc^Vws, Cw, Cw, Mm, Cw, Gd, Gd, Gll^Fmw, Gll^Fmw, Gd, Gll^Fp, Gd, Gd, Gd, Gd^Es, Gd^Es, Gd, Gll^Fp, Gll^Fp, Gll^Fp, Gll^Fp, Gll^Fp, Aa^Fpa
Mm, Mm, Ha^Fpa, Ha^Fpa, Ai, Wwg, Ai, Wwg, Ha^Fpa, Ha^Fpa, Mm, Mm, Mm, Mm, Gll^Fmw, Gll^Fmw, Cw, Mm, Mm, Ms, Ms, Cw, Kw, Ms^Xm, Ms^Xm, Ms^Xm, Kw, Cw, Mm, Mm, Mm, Cw, Cw, Gd, Gd, Gd, Gd, Gd, Gd, Gll^Fp, Gll^Fp, Gll^Fmw, Gll^Fmw, Gd, Gll^Fmw, Gll^Fmw, Gll^Fmw, Gll^Fp, Gd, Aa^Fpa, Aa^Fpa
Ha^Fpa, Ha^Fpa, Ha^Fpa, Ai, Wwg, Wwg, Ha^Fpa, Ha^Fpa, Mm, Mm, Mm, Mm, Mm, Mm, Mm, Gll^Fmw, Gll^Fmw, Mm, Mm, Mm, Mm, Mm, Rrc^Vws, Cw, Kw, Cw, Cw, Mm, Mm, Mm, Gd, Cw, Gd, Gd, Mm, Mm, Mm, Gd, Gd, Gll^Fp, Gll^Fp, Gll^Fmw, Aa^Fpa, Gll^Fmw, Gll^Fmw, Aa^Fpa, Aa^Fpa, Gll^Fmw, Gd, Aa^Fpa, Aa^Fpa
Wwg, Wwg, Wwg, Wwg, Ai, Ha^Fpa, Mm, Mm, Mm, Mm, Mm, Ms, Ms, Mm, Mm, Aa^Fpa, Aa^Fpa, Gll^Fmw, Gll^Fmw, Ha^Vws, Cw, Mm, Cw, Cw, Cw, Mm, Mm, Cw, Cw, Cw, Gd, Gd, Gd, Gd, Mm, Mm, Mm, Mm, Mm, Gd, Gd, Gll^Fmw, Aa^Fpa, Gll^Fmw, Aa^Fpa, Aa^Fpa, Gll^Fmw, Gll^Fmw, Gd, Gd, Gd
Ha^Fpa, Ai, Ha^Fpa, Ai, Ha^Fpa, Ha^Fpa, Mm, Mm, Mm, Mm, Mm, Ms, Ms, Mm, Mm, Mm, Mm, Aa^Fpa, Aa^Fpa, Gll^Fmw, Cw, Cw, Mm, Mm, Cw, Mm, Gd, Cw, Gd, Gd, Gd, Gd, Mm, Mm, Mm, Ms, Ms, Mm, Mm, Gd, Gd, Gll^Fmw, Aa^Fpa, Aa^Fpa, Gll^Fmw, Gll^Fmw, Gd, Gll^Fmw, Gd, Gd^Es, Gd
Mm, Ha^Fpa, Mm, Ha^Fpa, Mm, Mm, Mm, Mm, Mm, Mm, Mm, Mm, Mm, Mm, Mm, Ms, Ms, Mm, Aa^Vws, Gll^Fmw, Gll^Fmw, Cw, Gd, Cw, Cw, Cw, Gd, Gd, Gd, Gd, Mm, Mm, Mm, Mm, Mm, Ms, Ms, Mm, Mm, Gd, Gd, Gll^Fmw, Gll^Fmw, Aa^Fpa, Gll^Fmw, Gd, Gd, Gd, Gd, Gd, Gd
Mm, Mm, Mm, Mm, Mm, Mm, Ms, Ms, Mm, Mm, Mm, Mm, Mm, Mm, Mm, Mm, Mm, Mm, Mm, Aa^Fpa, Gll^Fmw, Aa^Fpa, Gd, Gd, Gd, Gd, Gd, Gd, Gd, Gd, Mm, Mm, Ms, Mm, Mm, Mm, Mm, Mm, Mm, Gd, Gd, Gd, Gd, Aa^Fpa, Gd, Gd, Gd, Gd, Aa, Aa, Gd
Mm, Mm, Mm, Mm, Mm, Ms, Mm, Mm, Mm, Mm, Mm, Mm, Hhd^Fmw, Hhd^Fmw, Hhd^Fmw, Mm, Mm, Mm, Mm, Gll^Fmw, Gd, Aa^Fpa, Gd, Gd, Gd, Gd, Gd^Es, Gd, Gd, Mm, Mm, Mm, Mm, Mm, Mm, Mm, Mm, Mm, Gd, Gd, Gd, Gd, Gd, Gd, Gd, Gd^Es, Gd, Aa^Vws, Gd, Aa, Gd
Mm, Mm, Mm, Mm, Mm, Mm, Mm, Mm, Mm, Mm, Mm, Mm, Hhd^Fmw, Hhd^Fmw, Hh^Vws, Hhd^Fmw, Hhd^Fmw, Hhd^Fmw, Hhd^Fmw, Hhd^Fmw, Gd, Gd, Gd, Gd, Gd, Gd, Gd^Es, Gd, Gd, Mm, Mm, Mm, Mm, Mm, Mm, Mm, Gd, Gd, Gd^Es, Gd, Aa, Gd, Gll^Fp, Gd, Gd, Gd^Es, Gd, Gd, Aa, Gd, Gd
Mm, Mm, Mm, Mm, Mm, Mm, Mm, Mm, Mm, Mm, Hhd^Fmw, Hhd^Fmw, Gll^Fmw, Gll^Fmw, Gll^Fmw, Gll^Fmw, Gll^Fmw, Gll^Fmw, Gll^Fmw, Gd, Gd, Gd, Aa, Gd^Es, Gd, Gd, Gd, Gd, Gd, Mm, Mm, Mm, Mm, Mm, Gd, Gd^Es, Gd, Gd, Gd, Gd, Aa^Fpa, Aa^Fpa, Aa^Fpa, Gll^Fp, Gd, Gd^Es, Gd, Aa, Gd, Gd, Gd
Mm, Mm, Mm, Mm, Mm, Mm, Mm, Mm, Mm, Hhd^Fmw, Hhd^Fmw, Gll^Fmw, Gll^Fmw, Gll^Fmw, Aa^Fpa, Gll^Fmw, Aa^Fpa, Aa^Fpa, Gd, Gd, Gd, Aa, Gd, Aa, Gd^Es, Aa, Aa, Aa^Vws, Aa, Gd, Gd, Gd, Gd, Gd^Es, Gd, Gd, Aa, Gd, Gll^Fp, Aa^Fpa, Gll^Fp, Aa^Fpa, Aa^Fpa, Aa^Fpa, Gd, Gd, Gd, Gd, Gd, Gd^Es, Gd
Hhd^Fmw, Mm, Mm, Mm, Mm, Mm, Hhd^Fmw, Mm, Hhd^Fmw, Hhd^Fmw, Gll^Fmw, Gll^Fmw, Gd, Aa^Fpa, Gd, Gd, Gd, Gd, Gd, Gd, Gd, Gd, Gd, Gd, Gd, Gd, Gd, Aa, Aa, Gd, Gd, Gd, Gd, Gd, Gd, Gd, Aa^Fpa, Aa^Fpa, Aa^Fpa, Aa^Fpa, Aa^Fpa, Gll^Fp, Gll^Fp, Gll^Fp, Gd, Gd, Gll^Fp, Gll^Fp, Gll^Fp, Gd, Gd
Gll^Fmw, Hhd^Fmw, Hhd^Fmw, Mm, Hhd^Fmw, Hhd^Fmw, Gll^Fmw, Hhd^Fmw, Gll^Fmw, Gll^Fmw, Gll^Fmw, Gd, Gd^Es, Gd, Gd, Gd, Gd, Gd, Aa, Gd, Gd, Gd, Aa, Gd, Gd, Gd^Es, Gd, Gd, Aa, Gd, Gd, Aa, Aa, Aa, Aa^Fpa, Gll^Fp, Gll^Fp, Aa^Fpa, Gll^Fp, Aa^Fpa, Aa^Fpa, Aa^Fpa, Aa, Gd, Gd, Gd, Gll^Fp, Gll^Fp, Aa^Fpa, Gll^Fp, Gll^Fp
Gll^Fmw, Gll^Fmw, Gll^Fmw, Hhd^Fmw, Gll^Fmw, Gll^Fmw, Gll^Fmw, Gll^Fmw, Aa^Fpa, Aa^Fpa, Gd, Gd, Gd, Gd, Gd, Aa, Aa, Gd, Aa^Vws, Aa, Gd, Gd, Gd, Aa, Gd, Gd^Es, Aa^Fpa, Gd, Gd, Gd, Aa, Aa, Aa^Fpa, Aa, Gll^Fp, Aa^Fpa, Aa^Fpa, Aa^Fpa, Aa^Fpa, Gll^Fp, Aa^Fpa, Aa, Gd, Gd, Gd, Gd, Aa^Fpa, Aa^Fpa, Aa^Fpa, Gll^Fp, Gll^Fp
Gll^Fmw, Gll^Fmw, Aa^Fpa, Gll^Fmw, Gll^Fmw, Gll^Fmw, Gd, Gd, Aa, Aa, Gd, Gd, Gd, Aa, Gd^Es, Gd, Gd, Gd, Gd, Gd, Gd, Gd, Gd, Gd^Es, Gd, Aa^Fpa, Aa^Fpa, Gll^Fp, Aa^Fpa, Aa^Fpa, Aa^Fpa, Aa^Fpa, Aa^Fpa, Aa^Vws, Gll^Fp, Aa^Fpa, Aa^Fpa, Aa^Fpa, Gll^Fp, Aa^Fpa, Aa, Aa, Gd, Gd, Gd, Gd, Aa^Fpa, Gll^Fp, Aa^Fpa, Gll^Fp, Gll^Fp
Aa^Fpa, Aa^Fpa, Gd, Aa^Fpa, Gd, Gd, Gd, Gd, Gd, Gd, Aa, Gd, Re^Vct, Gd, Gd, Gd, Gd, Aa, Gd, Gd^Es, Gd^Es, Aa, Gd^Es, Gd^Es, Aa^Fpa, Gll^Fp, Aa^Fpa, Aa^Fpa, Aa^Fpa, Gll^Fp, Gll^Fp, Aa^Fpa, Gll^Fp, Aa^Fpa, Aa^Fpa, Gll^Fp, Gll^Fp, Gll^Fp, Gd, Gd, Gd, Gd, Aa^Vws, Gd, Gd, Gll^Fp, Gll^Fp, Gll^Fp, Aa^Fpa, Gll^Fp, Gll^Fp
Aa^Fpa, Aa^Fpa, Gd, Gd, Gd, Gd^Es, Gd^Es, Gd, Aa, Aa, Gd, Gd, Gd, Gd, Gd, Gd, Gd, Aa, Aa, Gd, Gd, Gd, Gd, Gd, Aa^Fpa, Aa^Fpa, Gll^Fp, Gll^Fp, Gll^Fp, Aa^Fpa, Gll^Fp, Aa^Fpa, Gll^Fp, Aa^Fpa, Aa^Fpa, Aa^Fpa, Gd, Gd, Gd, Gd, Gd^Es, Gd^Es, Gd, Gd, Gd, Aa^Fpa, Gll^Fp, Gll^Fp, Aa^Fpa, Gll^Fp, Gll^Fp
Gll^Fp, Aa^Fpa, Gll^Fp, Gd, Gd, Gd, Gd, Gd, Aa, Gd, Gd^Es, Gd^Es, Aa, Aa, Cea, Cea, Cea, Gd, Aa, Re^Vct, Gd, Gd, Gd, Gd, Gd, Aa^Fpa, Aa^Fpa, Aa^Fpa, Gll^Fp, Aa^Fpa, Aa^Fpa, Gll^Fp, Aa^Fpa, Gll^Fp, Gd, Aa, Gd, Gd, Gd, Gd^Es, Gd, Gd, Aa^Fpa, Gd, Gll^Fp, Gll^Fp, Aa^Fpa, Aa^Fpa, Gll^Fp, Gll^Fp, Gll^Fp
Aa^Fpa, Aa^Fpa, Gll^Fp, Aa^Fpa, Aa^Fpa, Gd, Gd, Gd, Gd, Gd, Gd^Es, Aa, Aa, Cea, Cea, Cea, Cea, Cea, Aa, Gd, Gd, Aa, Aa^Es, Gd, Gd, Gd, Gd, Aa^Fpa, Aa^Fpa, Gll^Fp, Aa^Fpa, Gll^Fp, Gd, Gd, Gd, Gd, Gd, Gd, Gd, Gd^Es, Aa^Fpa, Aa^Fpa, Gll^Fp, Gll^Fp, Aa^Fpa, Gll^Fp, Gll^Fp, Aa^Fpa, Aa^Fpa, Aa^Fpa, Gll^Fp
Aa^Fpa, Aa^Fpa, Gll^Fp, Aa^Fpa, Aa^Fpa, Aa^Fpa, Gd, Gd, Aa, Gd, Re^Vct, Aa, Gd, Aa, Cea, 3 Kea, Cea, Aa, Gd, Gd, Gll^Fp, Aa^Fpa, Aa^Fpa, Gll^Fp, Aa^Fpa, Gd, Gd, Aa, Aa, Gd, Gd, Gd, Gd^Es, Gd, Gd, Gd, Gd, Gd, Aa^Fpa, Gd, Gll^Fp, Gll^Fp, Aa^Fpa, Aa^Fpa, Aa^Fpa, Gll^Fp, Gll^Fp, Gll^Fp, Aa^Fpa, Gll^Fp, Gll^Fp
Aa^Fpa, Aa^Fpa, Aa^Fpa, Gll^Fp, Gll^Fp, Gll^Fp, Gd, Re^Vct, Gd, Gd, Gd, Aa, Aa, Gd, Gd, Cea, Aa, Aa, Gd, Gd, Aa^Fpa, Gll^Fp, Gll^Fp, Gll^Fp, Aa^Fpa, Gd, Gd^Es, Gd, Gd, Gd, Gd, Gd, Gd, Gd, Aa^Fpa, Aa^Fpa, Gd, Gd, Gll^Fp, Gll^Fp, Gll^Fp, Gll^Fp, Gll^Fp, Gll^Fp, Aa^Fpa, Aa^Fpa, Aa^Fpa, Aa^Fpa, Gll^Fp, Gll^Fp, Gll^Fp
Aa^Fpa, Aa^Fpa, Aa^Fpa, Gll^Fp, Gll^Fp, Gll^Fp, Gd, Gd, Gd, Gd, Aa, Gd, Gd, Aa, Gd, Gd, Gd, Re^Vct, Gd, Gd, Gd, Gll^Fp, Aa^Fpa, Gll^Fp, Gd, Gd, Gd^Es, Gd, Gd, Gd, Gd, Gd^Es, Gd, Gd, Aa^Fpa, Aa^Fpa, Gll^Fp, Gll^Fp, Gll^Fp, Gll^Fp, Gll^Fp, Gll^Fp, Gll^Fp, Aa^Fpa, Aa^Fpa, Gll^Fp, Gll^Fp, Gll^Fp, Aa^Fpa, Gll^Fp, Gll^Fp
Aa^Fpa, Aa^Fpa, Gll^Fp, Gll^Fp, Aa^Fpa, Gll^Fp, Gll^Fp, Gd, Gd, Gd, Gd, Gd, Aa, Aa, Aa, Gd, Gd, Gd, Aa, Gd, Gd, Gd, Gd, Gd, Gd, Gd, Gd, Gd, Gd, Gd, Gd, Gd, Gll^Fp, Aa^Fpa, Aa^Fpa, Gll^Fp, Gll^Fp, Gll^Fp, Aa^Fpa, Aa^Fpa, Aa^Fpa, Gll^Fp, Gll^Fp, Aa^Fpa, Aa^Fpa, Aa^Fpa, Gll^Fp, Gll^Fp, Aa^Fpa, Gll^Fp, Gll^Fp
Gll^Fp, Gll^Fp, Aa^Fpa, Gll^Fp, Gll^Fp, Gll^Fp, Gll^Fp, Gll^Fp, Gll^Fp, Gd, Gd, Gd^Es, Aa, Gd, Gd, Aa, Aa, Gd, Gd, Gd, Aa^Fpa, Gd^Es, Gd^Es, Gd^Es, Gd^Es, Gd, Aa^Fpa, Aa^Fpa, Gll^Fp, Aa^Fpa, Gll^Fp, Gll^Fp, Gll^Fp, Gll^Fp, Gll^Fp, Gll^Fp, Gll^Fp, Aa^Fpa, Gll^Fp, Gll^Fp, Gll^Fp, Aa^Fpa, Aa^Fpa, Gll^Fp, Gll^Fp, Aa^Fpa, Gll^Fp, Gll^Fp, Aa^Fpa, Gll^Fp, Gll^Fp
Gll^Fp, Gll^Fp, Gll^Fp, Gll^Fp, Gll^Fp, Aa^Fpa, Gll^Fp, Aa^Fpa, Aa^Fpa, Gll^Fp, Gll^Fp, Gd, Gd, Gd, Gd, Gd, Gd, Aa, Aa, Gd, Aa^Fpa, Aa^Fpa, Aa^Fpa, Gd, Aa^Fpa, Aa^Fpa, Aa^Fpa, Gll^Fp, Gll^Fp, Gll^Fp, Aa^Fpa, Aa^Fpa, Aa^Fpa, Gll^Fp, Aa^Fpa, Gll^Fp, Aa^Fpa, Aa^Fpa, Aa^Fpa, Aa^Fpa, Gll^Fp, Gll^Fp, Aa^Fpa, Gll^Fp, Gll^Fp, Aa^Fpa, Aa^Fpa, Gll^Fp, Aa^Fpa, Gll^Fp, Gll^Fp
Gll^Fp, Gll^Fp, Gll^Fp, Gll^Fp, Gll^Fp, Aa^Fpa, Gll^Fp, Gll^Fp, Gll^Fp, Aa^Fpa, Aa^Fpa, Gd, Gd, Gd, Gd, Gd, Gd, Gd, Gd, Gd, Gd, Aa^Fpa, Aa^Fpa, Aa^Fpa, Aa^Fpa, Aa^Fpa, Gd, Gll^Fp, Gll^Fp, Aa^Fpa, Aa^Fpa, Aa^Fpa, Gll^Fp, Gll^Fp, Gll^Fp, Gll^Fp, Gll^Fp, Gll^Fp, Gll^Fp, Aa^Fpa, Gll^Fp, Aa^Fpa, Aa^Fpa, Gll^Fp, Gll^Fp, Gll^Fp, Gll^Fp, Aa^Fpa, Aa^Fpa, Gll^Fp, Gd
