border_size=1
usage=map

Xaw, Xaw, Xaw, Xaw, Xaw, Xaw, Xaw, Xaw, Iwr, Xaw, Xaw, Xaw, Xaw, Xaw, Xaw, Xaw, Xaw
Xaw, Xaw, Xaw, Xaw, Xaw, Xaw, Xaw, Xaw, Iwr, Xaw, Xaw, Xaw, Xaw, Xaw, Xaw, Xaw, Xaw
Xaw, Xaw, Xaw, Xaw, Xaw, Xaw, Iwr, Iwr, Iwr, Iwr, Iwr, Xaw, Xaw, Xaw, Xaw, Xaw, Xaw
Xaw, Xaw, Xaw, Xaw, Iwr^Ii, Iwr^Ii, Iwr, Xaw, Iwr, Xaw, Iwr, Iwr^Ii, Iwr^Ii, Xaw, Xaw, Xaw, Xaw
Xaw, Xaw, Iwr, Iwr^Ii, Iwr, Iwr, Iwr, Iwr, 2 Iwr^Ii, Iwr, Iwr, Iwr, Iwr, Iwr^Ii, Iwr, Xaw, Xaw
Xaw, Xaw, Iwr, Iwr, Xaw, Iwr, Iwr, Iwr, Iwr, Iwr, Iwr, Iwr, Xaw, Iwr, Iwr, Xaw, Xaw
Xaw, Xaw, Iwr, Iwr^Ii, Iwr, Iwr, 4 Iwr^Ii, Iwr, Iwr, Iwr, 3 Iwr^Ii, Iwr, Iwr, Iwr^Ii, Iwr, Xaw, Xaw
Xaw, Xaw, Iwr, Iwr^Ii, Iwr, Iwr, Iwr, Iwr, Iwr, Iwr, Iwr, Iwr, Iwr, Iwr^Ii, Iwr, Xaw, Xaw
Xaw, Xaw, Iwr, Iwr, Xaw, Iwr, Iwr, Iwr, Iwr, Iwr, Iwr, Iwr, Xaw, Iwr, Iwr, Xaw, Xaw
Xaw, Xaw, Iwr, Iwr^Ii, Iwr, Iwr, 5 Iwr^Ii, Iwr, Iwr, Iwr, 6 Iwr^Ii, Iwr, Iwr, Iwr^Ii, Iwr, Xaw, Xaw
Xaw, Xaw, Iwr, Iwr^Ii, Iwr, Iwr, Iwr, Iwr, Iwr, Iwr, Iwr, Iwr, Iwr, Iwr^Ii, Iwr, Xaw, Xaw
Xaw, Xaw, Iwr, Iwr, Xaw, Iwr, Iwr, Iwr, Iwr, Iwr, Iwr, Iwr, Xaw, Iwr, Iwr, Xaw, Xaw
Xaw, Xaw, Iwr, Iwr^Ii, Iwr, Iwr, 7 Iwr^Ii, Iwr, Iwr, Iwr, Iwr^Ii, Iwr, Iwr, Iwr^Ii, Iwr, Xaw, Xaw
Xaw, Xaw, Iwr, Iwr^Ii, Iwr, Iwr, Iwr, Iwr, 1 Iwr, Iwr, Iwr, Iwr, Iwr, Iwr^Ii, Iwr, Xaw, Xaw
Xaw, Xaw, Iwr, Iwr, Xaw, Iwr, Iwr, Iwr, Iwr, Iwr, Iwr, Iwr, Xaw, Iwr, Iwr, Xaw, Xaw
Xaw, Xaw, Iwr, Iwr^Ii, Iwr^Ii, Iwr, Iwr, Iwr, Iwr, Iwr, Iwr, Iwr, Iwr^Ii, Iwr^Ii, Iwr, Xaw, Xaw
Xaw, Xaw, Xaw, Iwr, Xaw, Iwr, Xaw, Iwr, Iwr, Iwr, Xaw, Iwr, Xaw, Iwr, Xaw, Xaw, Xaw
Xaw, Xaw, Xaw, Xaw, Xaw, Xaw, Xaw, Iwr, Iwr, Iwr, Xaw, Xaw, Xaw, Xaw, Xaw, Xaw, Xaw
