Xaw, Xaw, Xaw, Xaw, Xaw, Xaw, Xaw, Gg, Gg, Gg, Xaw, Xaw, Xaw, Xaw, Xaw, Xaw, Xaw
Xaw, Xaw, Xaw, Xaw, Xaw, Xaw, Gg^Efm, Rp^Ii, Rp^Ii, Rp^Ii, Gg, Xaw, Xaw, Xaw, Xaw, Xaw, Xaw
Xaw, Xaw, Xaw, Xaw, Gg^Efm, Gg, Gg, Gg^Fet, Rp^Ii, Gg^Fet, Gg, Gg^Efm, Gg, Xaw, Xaw, Xaw, Xaw
Xaw, Xaw, Gg^Efm, Gg, Wwt^Ii, Wwt^Ii, Wwt^Ii, Gg^Efm, Rp^Ii, Gg^Efm, Wwt^Ii, Wwt^Ii, Wwt^Ii, Gg^Efm, Gg, Xaw, Xaw
Xaw, Xaw, Gg, Wwt^Ii, Ww^Ewf, Ww^Ewf, Wwt^Ii, Gg^Fet, Rp^Ii, Gg^Fet, Wwt^Ii, Ww^Ewf, Ww^Ewf, Wwt^Ii, Gg^Efm, Xaw, Xaw
Xaw, Xaw, Gg^Efm, Wwt^Ii, Wwt^Ii, Wwt^Ii, Gg^Fet, Gg^Efm, Rp^Ii, Gg^Efm, Gg^Fet, Wwt^Ii, Wwt^Ii, Wwt^Ii, Gg, Xaw, Xaw
Gg, Xaw, Rp^Ii, Gg^Efm, Rp^Ii, Gg^Efm, Rp^Ii, Rp^Ii, Gg, Rp^Ii, Rp^Ii, Gg^Efm, Rp^Ii, Gg^Efm, Rp^Ii, Xaw, Gg
Gg, Rp^Ii, Gg, Rp^Ii, Wwt^Ii, Rp^Ii, Gg^Fet, Rp^Ii, Rp^Ii, Rp^Ii, Gg^Fet, Rp^Ii, Wwt^Ii, Rp^Ii, Gg, 1 Rp^Ii, Gg
Xaw, Xaw, Gg^Efm, Wwt^Ii, Ww^Ewf, Wwt^Ii, Wwt^Ii, Gg^Efm, Rp^Ii, Gg^Efm, Wwt^Ii, Wwt^Ii, Ww^Ewf, Wwt^Ii, Gg^Efm, Xaw, Xaw
Xaw, Xaw, Gg, Wwt^Ii, Ww^Ewf, Ww^Ewf, Wwt^Ii, Gg^Fet, Rp^Ii, Gg^Fet, Wwt^Ii, Ww^Ewf, Ww^Ewf, Wwt^Ii, Gg, Xaw, Xaw
Xaw, Xaw, Gg^Efm, Wwt^Ii, Wwt^Ii, Wwt^Ii, Gg^Efm, Gg^Efm, Rp^Ii, Gg^Efm, Gg^Efm, Wwt^Ii, Wwt^Ii, Wwt^Ii, Gg^Efm, Xaw, Xaw
Xaw, Xaw, Xaw, Gg, Gg^Efm, Wwt^Ii, Gg^Efm, Gg^Fet, Rp^Ii, Gg^Fet, Gg^Efm, Wwt^Ii, Gg^Efm, Gg, Xaw, Xaw, Xaw
Xaw, Xaw, Xaw, Xaw, Xaw, Gg, Gg^Fet, Gg^Efm, Rp^Ii, Gg^Efm, Gg^Fet, Gg, Xaw, Xaw, Xaw, Xaw, Xaw
Xaw, Xaw, Xaw, Xaw, Xaw, Xaw, Xaw, Rp^Ii, Gg, Rp^Ii, Xaw, Xaw, Xaw, Xaw, Xaw, Xaw, Xaw
Xaw, Xaw, Xaw, Xaw, Xaw, Xaw, Xaw, Gg, Gg, Gg, Xaw, Xaw, Xaw, Xaw, Xaw, Xaw, Xaw
