Hhd, Hhd, Hhd, Hhd, Hhd, Hhd, Hhd, Hhd, Hhd, Hhd, Hhd, Gd^Fetd, Gd^Fetd, Gd^Fetd, Gd^Fetd, Gd, Gs, Gs, Gs, Gs, Gs, Gs, Gs, Gs, Gs, Gs, Gs, Gs, Gs, Gs, Gs, Gs, Gs, Gs, Gs, Gs, Gs, Gs, Gs, Gs, Gs, Gs, Rp, Re, Re, Gs, Gs, Gs, Gs, Gs, Gs, Gs, Gs, Gs, Gs, Gs, Gs, Gs, Gs, Gs, Gs, Gd, Gd^Fetd, Gs^Fms, Hhd, Hhd, Hhd, Hhd, Hhd, Hhd, Hhd, Hhd
Hhd, Hhd, Hhd, Hhd, Hhd, Hhd, Hhd, Hhd, Hhd, Hhd, Hhd, Gd^Fetd, Gd^Ecf, Gd^Ecf, Gd^Ecf, Gd, Gs, Gs, Gs, Gs, Gs, Gs, Gs, Gs, Gs, Gs, Gd, Gs, Gd, Gs, Gd, Gs, Gs, Gs, Gd, Gs, Gs, Gs, Gs, Gs, Gs, Gs, Rp, Re, Re, Gs, Gs, Gs, Gs, Gs, Gs, Gs, Gs, Gs, Gd, Gs, Gs, Gs, Gs, Gs, Gd, Gd, Gd^Fetd, Gd^Fetd, Hhd, Hhd, Hhd, Hhd, Hhd, Hhd, Hhd, Hhd
Hhd, Hhd, Hhd, Hhd, Hhd, Hhd, Hhd, Hhd, Gd^Fetd, Hhd, Gd^Fetd, Gd^Fetd, Gd^Ecf, Gd^Ecf, Gd^Fetd, Gd, Gs, Gs, Gs, Gs, Gs, Gs, Gs, Gs, Gs, Gs, Gs, Gd, Gs, Gd, Gd, Gs, Gd, Gd, Gd^Fetd, Gd, Gd, Gs, Gs, Gs, Gs, Gs, Rp, Re, Re, Gs, Gs, Gs, Gs, Gs, Gd, Gs, Gs, Gs, Gd, Gs, Gs, Gs, Gs, Gs, Gd, Gd^Fetd, Gd^Ecf, Gd^Fetd, Gd^Fetd, Hhd, Hhd, Hhd, Hhd, Hhd, Hhd, Hhd
Hhd, Hhd, Hhd, Hhd, Hhd, Hhd, Hhd, Hhd, Gd^Fetd, Gd^Fetd, Gd^Ecf, Gd^Fetd, Gd^Fetd, Gd^Fetd, Gd, Gd, Gs, Gs, Gs, Gs, Gs, Gs, Gs, Gs, Gs, Gs, Gs, Gs, Gs, Gs, Gs, Gd, Gd^Ecf, Gd^Ecf, Gd^Ecf, Gd^Ecf, Gd^Ecf, Gd, Gd, Gs, Gs, Gs, Re, Re, Rp, Gs, Gs, Gs, Gs, Gd, Gs, Gd, Gs, Gd, Gs, Gs, Gs, Gs, Gs, Gs, Gd, Gd^Fetd, Gd^Fetd, Gd^Ecf, Gd^Fetd, Hhd, Hhd, Hhd, Hhd, Hhd, Hhd, Hhd
Hhd, Hhd, Hhd, Hhd, Hhd, Hhd, Hhd, Gd^Fetd, Gd^Ecf, Gd^Ecf, Gd^Ecf, Gd^Fetd, Gd, Gd, Gs, Gs, Gs, Gs, Gs, Gs, Gs, Gs, Gd, Gs, Gd, Gs, Gs, Gs, Gs, Gs, Gs, Gd, Gd^Fetd, Gd^Ecf, Gd^Fetd, Gd^Ecf, Gd^Ecf, Gd^Ecf, Gd^Fetd, Gd, Gd, Gs, Rp, Re, Rp, Gs, Gs, Gd, Gd, Gs, Gs, Gs, Gs, Gs, Gs, Gs, Gs, Gs, Gs, Gs, Gs, Gd, Gd^Fetd, Gd^Ecf, Gd^Ecf, Gd^Fetd, Gd^Fetd, Hhd, Hhd, Hhd, Hhd, Hhd
Hhd, Hhd, Hhd, Hhd, Hhd, Hhd, Gd^Ecf, Gd^Ecf, Gd^Fetd, Gd^Ecf, Gd^Fetd, Gd, Gd, Gs, Gs, Gs, Gs, Gd, Gd, Gd, Gd, Gd, Gs, Gd, Gs, Gd, Gd, Gs, Gs, Gs, Gd, Gd, Gd^Fetd, Gd^Ecf, Hhd, Hhd, Hhd, Gd^Ecf, Gd^Fetd, Gd^Fetd, Gd, Gd, Rp, Re, Re, Gs, Gs, Gd, Gs, Gs, Gs, Gs, Gs, Gs, Gd, Gd, Gd, Gd, Gs, Gs, Gs, Gd, Gd^Fetd, Gd^Fetd, Gd^Ecf, Gd^Fetd, Gd^Fetd, Hhd, Hhd, Hhd, Hhd, Hhd
Hhd, Hhd, Hhd, Hhd, Gd^Fetd, Gd^Ecf, Gd^Fetd, Gd^Fetd, Gd^Fetd, Gd^Fetd, Gd, Gd, Gs, Gs, Gs, Gs, Gs, Gs, Gd, Gs, Gd, Gd, Gs, Gs, Gs, Gs, Gd, Gs, Gs, Gs, Gd, Gd^Fetd, Gd^Ecf, Gd^Fetd, Hhd, Hhd, Hhd, Hhd, Hhd, Gd^Ecf, Gd^Fetd, Gd, Rp, Re, Rp, Gs, Gs, Gs, Gs, Gs, Gs, Gs, Gs, Gs, Gs, Gd, Gd, Gd, Gs, Gs, Gd, Gd, Gd, Gd^Ecf, Gd^Ecf, Gd^Ecf, Gd^Ecf, Gd^Fetd, Gd^Fetd, Hhd, Hhd, Hhd
Gd^Fetd, Hhd, Gd^Fetd, Gd^Ecf, Gd^Fetd, Gd^Fetd, Gd, Gd, Gd, Gd, Gd, Gd, Gs, Gs, Gs, Gs, Gs, Gs, Gs, Gs, Gs, Gs, Gs, Gs, Gs, Gs, Gs, Gs, Gs, Gs, Gd, Gd, Gd^Ecf, Gd^Fetd, Hhd, Hhd, Hhd, Hhd, Hhd, Gd^Ecf, Gd^Fetd, Gd^Fetd, Re, Re, Rp, Gs, Gs, Gs, Gs, Gs, Gd, Gd, Gd, Gs, Gs, Gs, Gs, Gs, Gs, Gs, Gd, Gs, Gd, Gd^Ecf, Gd^Ecf, Gd^Fetd, Gd^Ecf, Gd^Ecf, Gd^Fetd, Gd^Fetd, Gd^Fetd, Gd^Fetd
Gd^Fetd, Gd^Fetd, Gd^Ecf, Gd^Ecf, Gd, Gd, Gs, Gs, Gs, Gd, Gs, Gd, Gs, Gs, Gs, Gs, Gs, Gs, Gd, Gs, Gs, Gs, Gs, Gs, Gs, Gs, Gs, Gs, Gs, Gs, Gd, Gd^Fetd, Gd^Fetd, Gd^Fetd, Gd^Fetd, Hhd, Hhd, Hhd, Gd^Ecf, Gd^Ecf, Gd^Fetd, Gd^Fetd, Rp, Re, Rp, Gs, Gs, Gs, Gs, Gd, Gd, Rd, Gd, Gd, Gs, Gs, Gs, Gs, Gs, Gd, Gs, Gs, Gd, Gd^Fetd, Gd^Fetd, Gd^Fetd, Gd^Fetd, Gd^Ecf, Gd^Fetd, Gd^Ecf, Gd^Fetd, Gd^Fetd
Gd^Fetd, Gd^Ecf, Gd^Fetd, Gd, Gs, Gs, Gs, Gs, Gd, Gs, Gs, Gs, Gs, Gs, Gs, Gs, Gs, Gd, Gd, Gs, Gs, Gs, Gs, Gs, Gs, Gs, Gs, Gs, Gs, Gs, Gs, Gd, Gd, Gd, Gd, Gd^Fetd, Gd^Ecf, Gd^Ecf, Gd^Ecf, Gd^Ecf, Rp, Rp, Re, Re, Rp, Gs, Gs, Gs, Gs, Gd, Gd, Gd, Gd, Gd, Gs, Gs, Gs, Gs, Gs, Gs, Gs, Gs, Gs, Gd, Gd, Gd, Gd, Gd, Gd, Gd^Fetd, Gd, Gd^Fetd
Gd^Fetd, Gd^Fetd, Gd, Gd, Gs, Gs, Gs, Gs, Gd, Gs, Gs, Gs, Gs, Gs, Gs, Gs, Gs, Gs, Gd, Gs, Gd, Gs, Gd, Gs, Gs, Gs, Gs, Gs, Gs, Gs, Gs, Gs, Gs, Gd, Gd, Gd^Fetd, Gd^Ecf, Gd^Ecf, Gd, Rp, Re, Re, Re, Rp, Gs, Gs, Gs, Gs, Gs, Gs, Gs, Gd, Gs, Gs, Gs, Gs, Gs, Gs, Gs, Gs, Gs, Gs, Gs, Gs, Gs, Gs, Gd, Gd, Gs, Gd, Gd, Gd
Gd, Gd, Gd, Gd, Gd, Gs, Gd, Gs, Gd, Gd, Gd, Gs, Gs, Gs, Gs, Gs, Gs, Gs, Gs, Gs, Gs, Gd, Gs, Gs, Gs, Gs, Gs, Gs, Gs, Gs, Gs, Gs, Gs, Gs, Gs, Gd, Gd, Gd, Gs, Rp, Re, Rp, Gs, Gs, Gs, Gs, Gs, Gs, Gs, Gs, Gs, Gs, Gs, Gs, Gs, Gs, Gs, Gs, Gs, Gs, Gs, Gs, Gs, Gs, Gs, Gd, Gs, Gs, Gs, Gs, Gd, Gd
Gs, Gs, Gs, Gs, Gs, Gd, Gd, Gd, Gd, Gd, Gd, Gd, Gs, Gs, Gs, Gs, Gs, Gs, Gs, Gs, Gs, Gs, Gs, Gs, Gs, Gs, Gs, Gs, Gs, Gs, Gs, Gs, Gs, Gs, Gs, Gs, Gs, Gs, Gs, Rp, Re, Re, Gs, Gs, Gs, Gs, Gs, Gs, Gs, Gs, Gs, Gs, Gd, Gs, Gs, Gs, Gs, Gs, Gs, Gs, Gs, Gs, Gd, Gd, Gd, Gs, Gs, Gs, Gs, 1 Gd, Gd, Gd
Gs, Gs, Gs, Gs, Gs, Gs, Gd, Gd, Gs, Gs, Gd, Gs, Gs, Gs, Gs, Gs, Gs, Gs, Gs, Gs, Hhd, Hhd, Hhd, Gs, Gs, Gs, Gs, Gs, Gs, Gs, Gs, Gs, Gd, Gs, Gs, Gs, Gs, Gs, Gs, Re, Re, Re, Gs, Gs, Gs, Gs, Gs, Gd, Gs, Gs, Gs, Gs, Gd, Gd, Gd, Gs, Gd, Gs, Gs, Gs, Gs, Gd, Gs, Gs, Gs, Gs, Gs, Gs, Gs, Gs, Gd, Gd
Gs, Gs, Gs, Gs, Gs, Gd, Gd, Gd, Gs, Gs, Gs, Gs, Gs, Gs, Gs, Gs, Hhd, Hhd, Hhd, Hhd, Hhd, Hhd, Hhd, Hhd, Hhd, Gs, Gs, Gs, Gs, Gs, Gs, Gd, Gs, Gd, Gd, Gs, Gs, Gs, Gs, Re, Re, Rp, Gs, Gs, Gs, Gs, Gs, Gd, Gd, Gs, Gs, Gs, Gs, Gs, Gs, Gd, Gd, Gd, Gd, Gd, Gd, Gs, Gs, Gs, Gs, Gs, Gs, Gs, Gs, Gs, Gd, Gd
Gs, Gs, Gs, Gs, Gs, Gd, Gd, Gs, Gs, Gs, Gs, Gs, Gs, Gs, Gs, Gs, Hhd, Hhd, Hhd, Hhd, Hhd, Hhd, Hhd, Hhd, Hhd, Hhd, Gs, Gs, Gs, Gs, Gs, Gs, Gs, Gs, Gd, Gd, Gs, Gs, Gs, Rp, Re, Rp, Gs, Gs, Gs, Gs, Gs, Gs, Gs, Gs, Gd, Gd, Gd, Gs, Gd, Gs, Gd, Gs, Gs, Gs, Gs, Gs, Gs, Gs, Gs, Gs, Gs, Gs, Gs, Gs, Gd, Gd
Gs, Gs, Gs, Gs, Gs, Gd, Gs, Gd, Gs, Gs, Gs, Gs, Gs, Gs, Gs, Gs, Hhd, Hhd, Hhd, Hhd, Hhd, Hhd, Hhd, Hhd, Hhd, Hhd, Hhd, Gs, Gs, Gs, Gs, Gs, Gs, Gs, Gs, Gs, Gd, Gs, Gs, Re, Re, Re, Gs, Gs, Gs, Gs, Gd, Gd, Gs, Gs, Gs, Gs, Gs, Gd, Gd, Gs, Gs, Gs, Gs, Gs, Gs, Gs, Gs, Gs, Gs, Gs, Gs, Gs, Gd, Gd, Gd^Fetd, Gd
Gs, Gs, Gs, Gs, Gs, Gs, Gd, Gd, Gs, Gd, Gd, Gs, Gs, Gs, Hhd, Hhd, Hhd, Hhd, Hhd, Hhd, Hhd, Hhd, Hhd, Hhd, Hhd, Hhd, Hhd, Hhd, Gs, Gs, Gs, Gs, Gs, Gd, Gs, Gd, Gd, Gd, Gs, Rp, Re, Rp, Gs, Gs, Gs, Gs, Gs, Gd, Gd, Gd, Gs, Gs, Gd, Gd, Gs, Gs, Gd, Gs, Gs, Gs, Gs, Gs, Gs, Gs, Gs, Gs, Gs, Gs, Gd, Gd^Fetd, Gd^Ecf, Gd^Fetd
Gs, Gs, Gs, Gs, Gs, Gs, Gs, Gd, Gd, Gd, Gd, Gs, Gs, Gs, Gs, Hhd, Hhd, Hhd, Hhd, Hhd, Hhd, Hhd, Hhd, Hhd, Hhd, Hhd, Hhd, Hhd, Gs, Gs, Gs, Gs, Gd, Gs, Gd, Gs, Gs, Gs, Gs, Rp, Rp, Re, Gs, Gs, Gs, Gs, Gd, Gs, Gs, Gs, Gs, Gs, Gs, Gs, Gs, Gs, Gs, Gd, Gs, Gs, Gs, Gs, Gs, Gs, Gs, Gs, Gd, Gd, Gd^Fetd, Gd^Ecf, Gd^Fetd, Gd^Fetd
Gs, Gs, Gs, Gs, Gs, Gs, Gs, Gs, Gd, Gd, Gs, Gs, Gs, Gs, Gs, Gs, Hhd, Hhd, Hhd, Hhd, Hhd, Hhd, Hhd, Hhd, Hhd, Hhd, Gs, Gs, Gs, Gs, Gs, Gd, Gs, Gs, Gs, Gd, Gd, Gs, Gs, Rp, Re, Re, Gs, Gs, Gs, Gs, Gd, Gd, Gs, Gs, Gs, Gs, Gs, Gs, Gs, Gs, Gs, Gd, Gs, Gs, Gs, Gs, Gs, Gs, Gs, Gs, Gd, Gd^Fetd, Gd^Ecf, Gd^Ecf, Gd^Fetd, Gs^Fms
Gs, Gs, Gs, Gs, Gs, Gs, Gs, Gs, Gs, Gd, Gd, Gs, Gs, Gs, Gs, Gs, Gs, Hhd, Hhd, Hhd, Hhd, Hhd, Hhd, Hhd, Hhd, Hhd, Gs, Gs, Gs, Gs, Gs, Gs, Gd, Gs, Gs, Gs, Gd, Gs, Gs, Rp, Re, Rp, Gs, Gs, Gs, Gs, Gs, Gs, Gs, Gs, Gs, Gs, Gs, Gs, Gs, Gs, Gs, Gs, Gs, Gs, Gs, Gs, Gs, Gs, Gs, Gd, Gd^Fetd, Gd^Fetd, Gd^Ecf, Gd^Fetd, Gd^Fetd, Gs^Fms
Gs, Gs, Gs, Gs, Gs, Gs, Gs, Gs, Gs, Gd, Gd, Gd, Gs, Gs, Gs, Gs, Gs, Gs, Gs, Hhd, Gs, Hhd, Gs, Hhd, Gs, Gs, Gs, Gs, Gs, Gs, Gs, Gs, Gs, Gs, Gs, Gs, Gs, Gs, Gs, Re, Re, Rp, Gs, Gs, Gs, Gs, Gs, Gs, Gs, Gs, Gs, Gs, Gs, Gs, Gs, Gs, Gs, Gs, Gs, Gs, Gs, Gs, Gs, Gs, Gd, Gd, Gd^Ecf, Gd^Fetd, Gd^Fetd, Gs^Fms, Gs^Fms, Gs^Fms
Gs, Gs, Gs, Gs, Gd, Gd, Gd, Gs, Gs, Gd, Gd, Gd, Gd, Gs, Gs, Gs, Gs, Gs, Gs, Gs, Gs, Gs, Gs, Gs, Gs, Gs, Gs, Gs, Gs, Gs, Gs, Gs, Gs, Gs, Gs, Gs, Gs, Gs, Gs, Rp, Re, Rp, Gs, Gs, Gs, Gs, Gs, Gs, Gs, Gs, Gs, Gs, Gs, Gs, Gs, Gs, Gs, Gs, Gs, Gs, Gs, Gs, Gs, Gs, Gd, Gd^Fetd, Gd^Ecf, Gd^Fetd, Gs^Fms, Gs^Fms, Gs^Fms, Gs^Fms
Gs, Gs, Gd, Gd, Gd, Rd, Gd, Gd, Gs, Gd, Gd, Gd, Gd, Gd, Gd, Gd, Gd, Gs, Gs, Gs, Gs, Gs, Gs, Gs, Gs, Gs, Gs, Gs, Gs, Gs, Gs, Gs, Gs, Gs, Gs, Gs, Gs, Gs, Gs, Re, Re, Re, Gs, Gs, Gs, Gs, Gs, Gs, Gs, Gs, Gs, Gs, Gs, Gs, Gs, Gs, Gs, Gs, Gs, Gs, Gs, Gs, Gs, Gs, Gd, Gd^Ecf, Gd^Fetd, Gd^Fetd, Gd^Fetd, Gs^Fms, Gs^Fms, Gs^Fms
Gd, Gd, Gd, Gd, Gd, Gd, Gd, Gd, Gs, Gs, Gd, Gd, Gs, Gd, Gd, Gd, Gs, Gs, Gd, Gs, Gs, Gs, Gs, Gs, Gs, Gs, Gs, Gs, Gs, Gs, Gs, Gs, Gs, Gs, Gs, Gs, Gs, Gs, Gs, Re, Re, Re, Gs, Gs, Gs, Gs, Gs, Gs, Gs, Gs, Gs, Gs, Gs, Gs, Gs, Gs, Gs, Gs, Gs, Gs, Gs, Gs, Gs, Gs, Gd, Gd^Ecf, Gd^Ecf, Gd^Fetd, Gd^Fetd, Gs^Fms, Gd^Fetd, Gs^Fms
Gd, Gd, Gd, Gs, Gs, Gd, Gd, Gs, Gs, Gs, Gd, Gd, Gd, Gd, Gs, Gd, Gd, Gs, Gd, Gd, Gd, Gs, Gs, Gs, Gs, Gs, Gs, Gs, Gs, Gs, Gs, Gs, Gs, Gs, Gs, Gs, Gs, Gs, Gs, Re, Re, Re, Gs, Gs, Gs, Gs, Gs, Gs, Gs, Gs, Gs, Gs, Gs, Gs, Gs, Gs, Gs, Gs, Gs, Gs, Gs, Gs, Gs, Gs, Gd, Gd^Fetd, Gd^Ecf, Gd^Fetd, Gd^Ecf, Gd^Fetd, Gd^Fetd, Gd^Fetd
Gd, Gd, Gd, Gs, Gs, Gs, Gd, Gd, Gd, Gd, Gd, Gd, Gd, Gd, Gd, Gs, Gd, Gd, Gd, Gs, Gs, Gs, Gs, Gs, Gd, Gs, Gs, Gs, Gs, Gs, Gs, Gs, Gs, Gs, Gs, Gs, Gs, Gs, Gs, Re, Re, Re, Gs, Gs, Gs, Gs, Gs, Gs, Gs, Gs, Gs, Gs, Gs, Gs, Gs, Gs, Gs, Gs, Gs, Gs, Gs, Gs, Gs, Gs, Gs, Gd, Gd^Fetd, Gd^Ecf, Gd^Fetd, Gd^Fetd, Gll, Gd^Fetd
Gd, Gd, Gs, Gs, Gs, Gd, Gs, Gd, Gd, Gs, Gd, Gs, Gd, Gd, Gd, Gd, Gd, Gd, Gs, Gs, Gs, Gs, Gs, Gs, Gd, Gs, Gs, Gs, Gs, Gs, Gs, Gs, Gs, Gs, Gs, Gs, Qxe, Gs, Cvr, Re, Gg^Bsb|, Re, Cvr^Dr, Gs, Qxe, Gs, Gs, Gs, Gs, Gs, Gs, Gs, Gs, Gs, Gs, Gs, Gs, Gs, Gs, Gs, Gs, Gs, Gd, Gd, Gd, Gd, Gll, Gd^Fetd, Gll, Gll, Gll, Gll
Gs, Gs, Gs, Gs, Gs, Gs, Gs, Gd, Gd, Gd, Gd, Gs, Gs, Gd, Gs, Gd, Gs, Gd, Gd, Gd, Gs, Gs, Gs, Gd, Gs, Gs, Gs, Gs, Gs, Gs, Gs, Gs, Gs, Gs, Qxe, Qxe, Cvr^Dr, Qxe, Cvr^Dr, Ww^Bsb|, Wwg, Ww^Bsb|, Cvr^Ecf, Qxe, Cvr^Dr, Qxe, Qxe, Gs, Gs, Gs, Gs, Gs, Gs, Gs, Gs, Gs, Gs, Gs, Gs, Gs, Gs, Gs, Gs, Gs, Gd, Gd, Gll, Gll, Gd^Ecf, Gd^Ecf, Gd^Ecf, Gll
Gs, Gs, Gs, Gs, Gs, Gs, Gs, Gs, Gs, Gd, Gs, Gs, Gs, Gs, Gs, Gs, Gs, Gs, Gs, Gs, Gs, Gs, Gs, Gd, Gs, Gs, Gs, Gs, Gs, Gs, Gs, Gs, Qxe, Qxe, Cvr^Ecf, Cvr^Dr, Wwg, Cvr^Dr, Wwg, Wwg, Cvr^Dr, Wwg, Wwg, Cvr^Ecf, Wwg, Cvr^Ecf, Cvr^Ecf, Qxe, Qxe, Gs, Gs, Gs, Gs, Gs, Gs, Gs, Gs, Gs, Gs, Gs, Gs, Gs, Gs, Gs, Gd, Gd, Gd^Fetd, Gd^Ecf, Gd^Fetd, Gd^Ecf, Gd^Ecf, Gd^Fetd
Gs, Gs, Gs, Gs, Gs, Gs, Gs, Gs, Gs, Gs, Gs, Gs, Gs, Gs, Gs, Gd, Gd, Gs, Gd, Gd, Gd, Gs, Gs, Gs, Gs, Gs, Gs, Gs, Gs, Gs, Qxe, Qxe, Cvr^Ecf, Cvr^Dr, Wwg, Wwg, Cvr, Wwg, Wwg, Cvr^Dr, Kvr, Cvr, Wwg, Wwg, Cvr^Dr, Wwg, Wwg, Cvr^Dr, Cvr^Ecf, Qxe, Qxe, Gs, Gs, Gs, Gs, Gs, Gs, Gs, Gs, Gs, Gs, Gs, Gs, Gs, Gs, Gd, Gd^Ecf, Gd^Ecf, Hhd, Gd^Fetd, Gs^Fms, Gd^Fetd
Gs, Gs, Gs, Gs, Gs, Gs, Gs, Gs, Gs, Gs, Gs, Gd, Gs, Gs, Gs, Gs, Gs, Gs, Gd, Gs, Gs, Gs, Gs, Gs, Gs, Gs, Gs, Gs, Qxe, Qxe, Cvr^Dr, Cvr^Ecf, Wwg, Wwg, Cvr^Dr, Kvr, Rr, Kvr, Rr, Cvr, Cvr^Dr, Cvr^Dr, Rr, Kvr, Rr, Kvr, Cvr^Dr, Wwg, Wwg, Cvr, Cvr^Dr, Qxe, Qxe, Gs, Gs, Gs, Gs, Gs, Gs, Gs, Gd, Gs, Gs, Gd, Gd, Gd, Gd^Ecf, Gd^Ecf, Hhd, Hhd, Gs^Fms, Gs^Fms
Re, Rp, Rp, Rp, Rp, Gs, Gs, Gs, Gd, Gd, Gs, Gs, Gs, Gs, Gs, Gs, Gd, Gs, Gs, Gs, Gs, Gs, Gs, Gs, Gs, Gs, Gs, Qxe, Qxe, Cvr, Wwg, Wwg, Cvr^Dr, Kvr, Rr^Dr, Rr, Rr, Rr, Rr, Cvr^Dr, Rr, Cvr, Rr, Rr, Rr, Rr^Dr, Rr, Kvr, Cvr^Dr, Wwg, Wwg, Cvr^Dr, Qxe, Qxe, Gs, Gs, Gs, Gs, Gs, Gs, Gs, Gd, Gd, Gd, Gd, Gd^Fetd, Gd^Ecf, Hhd, Hhd, Hhd, Hhd, Gs^Fms
Rp, Re, Re, Re, Re, Re, Re, Gs, Gs, Gs, Gs, Gs, Gs, Gs, Gs, Gd, Gs, Gd, Gs, Gs, Gs, Gs, Gs, Gs, Gs, Gs, Re, Qxe, Cvr^Ecf, Cvr^Ecf, Wwg, Kvr, Rr^Dr, Rr^Dr, Rr, Rr^Dr, Kvr, Cvr^Ecf, Kvr, Rr, Rp^Vhcr, Rr, Kvr, Cvr, Kvr^Ecf, Rr, Rr, Rr, Rr^Dr, Kvr, Wwg, Cvr^Dr, Cvr, Qxe, Re, Gs, Gs, Gs, Gs, Gs, Gs, Gs, Gs, Gd, Gd^Fetd, Gd^Ecf, Gd^Fetd, Hhd, Hhd, Hhd, Hhd, Gs^Fms
Gd^Fetd, Rp, Gd^Ecf, Rp^Ecf, Rp^Ecf, Rp, Re, Rp, Rp, Gs, Gs, Gs, Gs, Gs, Gs, Gs, Gs, Gs, Gs, Gs, Gs, Gs, Gs, Gs, Gs, Rp, Re, Re, Cvr^Ecf, Wwg, Kvr, Cvr, Rr^Dr, Rr^Ecf, Cvr^Ecf, Kvr, Rr, Rr, Rr, Rr, Rr, Rr, Rr, Rr, Rr, Kvr^Ecf, Cvr^Dr, Rr, Rr, Cvr^Dr, Kvr, Wwg, Cvr^Ecf, Rp, Re, Rp, Rp, Gs, Gs, Gs, Gs, Gs, Gs, Gd, Gd^Ecf, Gd^Fetd, Gd^Fetd, Hhd, Hhd, Hhd, Gd^Fetd, Gd^Fetd
Hhd, Gd^Fetd, Hhd, Gd^Ecf, Gd^Fetd, Gd^Ecf, Rp, Re, Re, Rp, Re, Gs, Gs, Gs, Gs, Gs, Gs, Gs, Gs, Gs, Gs, Gs, Gs, Gs, Gs, Re, Rp, Gg^Bsb\, Ww^Bsb\, Wwg, Rr, Rr, Rr^Dr, Rr, Kvr, Rr, Rp^Vhcr, Rr, Kvr, Rr, Cvr^Dr, Rr, Kvr^Ecf, Rr, Rp^Vhcr, Rr, Kvr, Rr, Rr, Rr^Dr, Rr^Dr, Wwg, Ww^Bsb/, Gg^Bsb/, Rp, Re, Re, Re, Re, Gs, Rp, Gs, Gs, Gd, Gd^Fetd, Gd^Ecf, Gd^Ecf, Gd^Fetd, Gd^Ecf, Gd^Fetd, Gd^Fetd, Gd^Fetd
Hhd, Hhd, Hhd, Hhd, Hhd, Gd^Ecf, Gd^Ecf, Rp, Rp, Re, Re, Rp, Re, Rp, Re, Rp, Re, Rp, Re, Rp, Re, Rp, Re, Rp, Re, Re, Cvr^Dr, Cvr, Wwg, Wwg, Cvr, Cvr^Dr, Kvr, Rr, Rr, Rr, Rr, Rr, Cvr^Dr, Cvr^Ecf, Kvr, Cvr^Dr, Cvr^Dr, Rr, Rp^Vhcr, Rr^Ecf, Rr, Rr, Kvr, Cvr, Cvr^Ecf, Wwg, Wwg, Cvr^Ecf, Cvr^Dr, Rp, Gs, Re, Re, Rp, Re, Rp, Rp, Gd, Gd, Gd^Fetd, Gd^Fetd, Gd^Fetd, Gd^Fetd, Gd^Fetd, Gll, Gll
Hhd, Hhd, Hhd, Hhd, Hhd, Hhd, Hhd, Gd^Ecf, Gd^Fetd, Rp, Re, Re, Re, Re, Rp, Re, Rp, Re, Re, Re, Re, Re, Rp, Re, Re, Re, Cvr^Dr, Wwg, Wwg, Cvr^Dr, Cvr^Dr, Cvr^Dr, Cvr, Rr, Rr, Rr, Rp^Vhcr, Rr, Cvr^Dr, Dd^Dc, Dd^Dc, Dd^Dc, Cvr^Dr, Rr, Rr, Rp^Vhcr, Rr, Rr, Cvr, Cvr, Cvr, Cvr^Ecf, Wwg, Wwg, Cvr^Dr, Rp, Gs, Re, Re, Rp, Re, Re, Re, Rp, Re, Rp, Re, Re, Rp, Rp, Re, Rp
Hhd, Hhd, Hhd, Hhd, Hhd, Hhd, Hhd, Gd^Ecf, Re^Ecf, Re, Rp, Re, Gs, Re, Gs, Rp, Gs, Rp, Gs, Re, Gs, Rp, Gs, Rp, Gs, Re, Re, Cvr, Ww^Bsb/, Wwg, Rr, Cvr, Rr, Rr, Kvr, Rr^Ecf, Rp^Vhcr, Rr, Kvr, Dd^Dc, Cvr^Ecf, Dd^Dc, Kvr^Ecf, Rr, Rp^Vhcr, Rr, Kvr, Rr, Rr, Cvr^Ecf, Rr^Dr, Wwg, Ww^Bsb\, Cvr^Dr, Re, Re, Re, Re, Re, Re, Rp, Rp, Rp, Re, Rp, Re, Rp, Re, Re, Re, Rp, Rp
Gd^Fetd, Hhd, Hhd, Hhd, Hhd, Hhd, Hhd, Gd^Fetd, Rp, Re, Rp, Gs, Gs, Gs, Gs, Gs, Gs, Gs, Gs, Gs, Gs, Gs, Gs, Gs, Gs, Re, Re, Gg^Bsb/, Cvr, Wwg, Kvr^Dr, Rr, Rr, Rr, Cv^Dr, Rr, Rr^Ecf, Rr, Rr, Rr, Rr, Rr, Rr, Rr, Rr, Rr, Cvr^Dr, Rr, Rr, Rr, Kvr, Wwg, Cvr^Dr, Gg^Bsb\, Re, Re, Re, Re, Gs, Gs, Gs, Gs, Gs, Rp, Gd, Rp, Gd^Fetd, Re, Gd^Fetd, Rp, Gll, Gll
Gd^Fetd, Gd^Fetd, Hhd, Hhd, Hhd, Hhd, Gd^Ecf, Rp^Ecf, Re, Re, Gs, Gs, Gs, Gs, Gs, Gs, Gs, Gs, Gs, Gs, Gs, Gs, Gs, Gs, Gs, Rp, Re, Rp, Cvr^Dr, Wwg, Wwg, Cvr, Rr^Ecf, Rr, Rr, Kvr, Kvr, Rr, Kvr, Rr, Rp^Vhcr, Rr, Kvr, Rr, Kvr^Ecf, Kvr, Rr^Dr, Rr, Rr^Ecf, Cvr, Wwg, Wwg, Cvr^Ecf, Rp, Re, Re, Gs, Gs, Gs, Gs, Gs, Gs, Gs, Gd, Gd^Fetd, Gd^Fetd, Gd^Ecf, Gd^Fetd, Gd^Ecf, Gd^Fetd, Gd^Fetd, Gll
Rp, Gd^Ecf, Gd^Ecf, Gd^Fetd, Hhd, Gd^Ecf, Rp, Re, Re, Rp, Gs, Gs, Gs, Gs, Gs, Gs, Gs, Gs, Gs, Gd, Gs, Gs, Gs, Gs, Gs, Gs, Gs, Qxe, Qxe, Cvr^Dr, Wwg, Kvr^Dr, Cvr^Dr, Rr, Rr, Rr, Rr, Cv^Dr, Rr, Rr, Rr, Rr, Rr, Cvr^Dr, Rr^Ecf, Rr, Rr, Rr, Cvr^Dr, Kvr, Wwg, Cvr^Ecf, Qxe, Qxe, Gs, Gs, Gs, Gs, Gs, Gs, Gd, Gs, Gs, Gd, Gd^Fetd, Gd^Ecf, Gd^Fetd, Gd^Fetd, Gd^Fetd, Gd^Ecf, Gd^Ecf, Gd^Fetd
Rp, Re, Re, Gd^Ecf, Gd^Ecf, Gd^Ecf, Re, Re, Re, Rp, Gs, Gs, Gd, Gd, Gs, Gs, Gs, Gs, Gd, Gd, Gs, Gd, Gs, Gs, Gs, Gs, Gs, Qxe, Qxe, Cvr, Cvr^Dr, Wwg, Wwg, Kvr^Dr, Cvr^Dr, Rr, Rr^Dr, Rr, Rr, Cvr, Cvr^Dr, Cvr^Dr, Rr, Rr, Rr, Rr, Cvr^Dr, Kvr, Wwg, Wwg, Cvr^Ecf, Cvr^Dr, Qxe, Qxe, Gs, Gs, Gs, Gs, Gs, Gd, Gs, Gd, Gd, Gd, Gd^Ecf, Gd^Ecf, Gd^Fetd, Hhd, Hhd, Gd^Fetd, Gd^Fetd, Gd^Fetd
Re, Re, Re, Rp, Rp, Rp, Re, Re, Re, Rp, Gs, Gs, Gd, Gs, Gd, Gs, Gs, Gs, Gs, Gs, Gs, Gd, Gs, Gd, Gd, Gs, Gs, Gs, Gs, Qxe, Qxe, Cvr^Ecf, Cvr^Dr, Wwg, Wwg, Kvr, Cvr^Dr, Kvr, Wwg, Cvr^Dr, Kvr^Ecf, Cvr, Wwg, Kvr, Cvr^Dr, Kvr, Wwg, Wwg, Cvr^Dr, Cvr^Dr, Qxe, Qxe, Gs, Gs, Gs, Gs, Gs, Gs, Gs, Gs, Gs, Gs, Gd, Gd, Gd^Ecf, Gd^Fetd, Hhd, Hhd, Hhd, Hhd, Gs^Fms, Gs^Fms
Rp, Rp, Rp, Re, Re, Re, Rp, Rp, Rp, Rp, Gs, Gs, Gs, Gd, Gs, Gs, Gd, Gd, Gs, Gs, Gs, Gd, Gd, Gs, Gs, Gd, Gs, Gs, Gs, Gs, Gs, Qxe, Qxe, Cvr, Cvr^Dr, Wwg, Wwg, Wwg, Wwg, Cvr, Cvr^Dr, Cvr^Dr, Wwg, Wwg, Wwg, Wwg, Cvr^Ecf, Cvr^Dr, Qxe, Qxe, Gs, Gs, Gs, Gs, Gs, Gs, Gs, Gs, Gs, Gs, Gs, Gs, Gd, Gd, Gd^Ecf, Gd^Fetd, Hhd, Hhd, Hhd, Hhd, Gs^Fms, Gs^Fms
Gs, Gs, Gs, Rp, Rp, Rp, Rp, Rp, Gs, Gs, Gs, Gs, Gs, Gs, Gs, Gs, Gs, Gs, Gs, Gs, Gd, Gs, Gs, Gs, Gs, Gs, Gs, Gs, Gs, Gs, Gs, Gs, Gs, Qxe, Qxe, Cvr^Ecf, Cvr^Ecf, Cvr^Dr, Cvr^Dr, Wwg, Wwg, Wwg, Cvr^Dr, Cvr^Dr, Cvr^Dr, Cvr^Ecf, Qxe, Qxe, Gs, Gs, Gs, Gs, Gs, Gs, Gs, Gs, Gs, Gs, Gs, Gs, Gs, Gs, Gd, Gd^Fetd, Gd^Ecf, Gd^Ecf, Gd^Fetd, Hhd, Gd^Fetd, Gd^Fetd, Gd^Fetd, Gs^Fms
Gs, Gs, Gs, Gs, Gs, Gs, Gs, Gs, Gs, Gs, Gs, Gs, Gd, Gs, Gd, Gs, Gs, Gs, Gd, Gd, Gs, Gs, Gs, Gs, Gs, Gd, Gd, Gs, Gs, Gs, Gs, Gs, Gs, Gs, Gs, Qxe, Qxe, Qxe, Cvr^Ecf, Ww^Bsb|, Gg^Bsb|, Wwg, Cvr, Qxe, Qxe, Qxe, Gs, Gs, Gs, Gs, Gs, Gs, Gs, Gs, Gs, Gs, Gs, Gs, Gs, Gs, Gs, Gs, Gd, Gd^Fetd, Gd^Fetd, Gd^Ecf, Gd^Fetd, Gd^Ecf, Gd^Ecf, Gd^Fetd, Gd^Ecf, Gs^Fms
Gs, Gs, Gs, Gs, Gs, Gs, Gs, Gs, Gd, Gs, Gd, Gd, Gs, Gs, Gs, Gd, Gs, Gs, Gd, Gs, Gs, Gs, Gs, Gs, Gs, Gs, Gs, Gs, Gs, Gs, Gs, Gs, Gs, Gs, Gs, Gs, Gs, Gs, Gs, Gg^Bsb|, Rp, Gg^Bsb|, Gs, Gs, Gs, Gs, Gs, Gs, Gs, Gs, Gs, Gs, Gs, Gs, Gs, Gs, Gs, Gs, Gs, Gs, Gd, Gd, Gd^Ecf, Re, Re, Gd^Fetd, Gd^Fetd, Gd^Ecf, Gd^Fetd, Gd^Fetd, Gd^Fetd, Gd^Fetd
Gs, Gs, Gs, Gs, Gs, Gs, Gs, Gs, Gs, Gd, Gd, Gs, Gs, Gs, Gs, Gs, Gs, Gs, Gs, Gs, Gs, Gs, Gs, Gs, Gs, Gs, Gs, Gs, Gs, Gd, Gs, Gs, Gs, Gs, Gs, Gs, Gs, Gs, Gs, Re, Re, Rp, Gs, Gs, Gs, Gs, Gs, Gs, Gs, Gs, Gs, Gs, Gs, Gs, Gs, Gs, Gs, Gs, Gs, Gs, Gd, Gd^Fetd, Gd^Ecf, Gd^Ecf, Gd^Ecf, Gs, Re^Ecf, Gd^Ecf, Re, Gd^Fetd, Gs, Re
Gs, Gs, Gs, Gs, Gs, Gs, Gs, Gs, Gs, Gs, Gs, Gs, Gs, Gs, Gs, Gs, Gs, Gs, Gs, Gs, Gs, Gs, Gs, Gs, Gs, Gs, Gs, Gs, Gs, Gd, Gs, Gs, Gs, Gs, Gs, Gs, Gs, Gs, Gs, Re, Re, Re, Gs, Gs, Gs, Gs, Gs, Gs, Gs, Gs, Gs, Gs, Gs, Gs, Gs, Gs, Gs, Gs, Gd, Gd, Gd^Fetd, Gd^Fetd, Gd^Fetd, Gd^Fetd, Gd^Fetd, Gd^Fetd, Gd^Fetd, Gd^Ecf, Gd^Ecf, Gs, Re, Gs
Gs, Gs, Gs, Gs, Gs, Gs, Gs, Gs, Gd, Gs, Gs, Gs, Gs, Gs, Gs, Gs, Gs, Gs, Gs, Gs, Gs, Gs, Gs, Gs, Gs, Gs, Gs, Gs, Gs, Gd, Gs, Gs, Gs, Gs, Gs, Gs, Gs, Gs, Gs, Rp, Re, Rp, Gs, Gs, Gs, Gs, Gs, Gs, Gs, Gs, Gs, Gs, Gs, Gs, Gs, Gs, Gs, Gd, Gd^Fetd, Gd^Fetd, Gd^Ecf, Gd^Ecf, Hhd, Gd^Fetd, Hhd, Hhd, Hhd, Gd^Fetd, Gd^Ecf, Re, Gs, Gs
Gs, Gs, Gs, Gs, Gs, Gs, Gd, Gd, Gd, Gd, Gd, Gs, Gs, Gs, Gd, Gs, Gs, Gs, Gs, Gs, Gs, Gs, Gs, Gs, Gs, Gs, Gs, Gs, Gs, Gs, Gs, Gs, Gs, Gd, Gs, Gs, Gs, Gs, Gs, Rp, Re, Re, Gs, Gs, Gs, Gs, Gs, Gs, Gs, Gs, Gs, Gs, Gs, Gs, Gs, Gs, Gs, Gd, Gd^Fetd, Gd^Fetd, Gd^Fetd, Gd^Fetd, Hhd, Hhd, Gd^Fetd, Hhd, Hhd, Gd^Fetd, Gd^Fetd, Gd^Ecf, Gd^Fetd, Gs
Gs, Gs, Gs, Gs, Gs, Gs, Gd, Gd, Gd, Gd, Gd, Gs, Gs, Gs, Gd, Gs, Gs, Gs, Gs, Gs, Gs, Gs, Gs, Gs, Gs, Gs, Gs, Gs, Gs, Gd, Gs, Gd, Gs, Gd, Gs, Gs, Gs, Gs, Gs, Rp, Re, Rp, Gs, Gs, Gs, Gs, Gs, Gs, Gs, Gs, Gs, Gs, Gs, Gs, Gs, Gs, Gs, Gd, Gd^Fetd, Gd^Ecf, Gd^Fetd, Gd^Fetd, Gd^Fetd, Hhd, Hhd, Gd^Fetd, Hhd, Hhd, Gs^Fms, Gd^Fetd, Gs^Fms, Gs^Fms
Gs, Gs, Gs, Gs, Gs, Gs, Gs, Gd, Gd, Gd, Gs, Gs, Gd, Gd, Gs, Gs, Gs, Gs, Gs, Gs, Gs, Gs, Gs, Gs, Gs, Gs, Gs, Gs, Gs, Gs, Gs, Gs, Gs, Gs, Gs, Gs, Gs, Gs, Gs, Re, Re, Rp, Gs, Gs, Gs, Gs, Gs, Gs, Gs, Gs, Gs, Gs, Gs, Gs, Gs, Gs, Gs, Gd, Gd, Gd^Ecf, Gd^Fetd, Gd^Fetd, Gd^Ecf, Gd^Fetd, Gd^Fetd, Hhd, Hhd, Hhd, Gs^Fms, Gd^Fetd, Gs^Fms, Gs^Fms
Gs, Gs, Gs, Gs, Gs, Gs, Gs, Gs, Gs, Gs, Gs, Gs, Gs, Gd, Gs, Gs, Gs, Gs, Gs, Gs, Gs, Gs, Gs, Gs, Gs, Gs, Gs, Gs, Gd, Gs, Gs, Gs, Gs, Gs, Gs, Gs, Gs, Gs, Gs, Rp, Re, Rp, Gs, Gs, Gs, Gs, Gs, Gs, Gs, Gs, Gs, Gs, Gs, Gs, Gs, Gs, Gs, Gd, Gs, Gd, Gd, Gd^Fetd, Gd^Fetd, Gd^Ecf, Gd^Fetd, Gd^Ecf, Gd^Ecf, Gs^Fms, Gd^Fetd, Gs^Fms, Gs^Fms, Gs^Fms
Gs, Gs, Gs, Gs, Gs, Gs, Gs, Gs, Gs, Gs, Gs, Gs, Gs, Gs, Gs, Gs, Gs, Gs, Gs, Gs, Gs, Gs, Gs, Gs, Gs, Gs, Gs, Gs, Gs, Gd, Gs, Gs, Gd, Gd, Gd, Gs, Gs, Gs, Gs, Re, Re, Re, Gs, Gs, Gs, Gs, Gs, Gs, Gs, Gs, Gs, Gs, Gs, Gs, Gs, Gs, Gs, Gs, Gs, Gs, Gs, Gd, Gd, Gd^Fetd, Gd, Gd^Fetd, Gd^Fetd, Gd^Fetd, Gd^Fetd, Gs^Fms, Gs^Fms, Gs^Fms
Gs, Gs, Gs, Gs, Gs, Gs, Rp, Gs, Gs, Gs, Gs, Gs, Gs, Gs, Gs, Gs, Gs, Gs, Gs, Gs, Gs, Gs, Gs, Gs, Gs, Gs, Gs, Gs, Gs, Gs, Gs, Gs, Gd, Gd, Gs, Gs, Gs, Gs, Rp, Rp, Re, Rp, Gs, Gs, Gs, Gs, Gs, Gs, Gs, Gs, Gs, Gs, Gs, Gs, Gs, Gs, Gs, Gs, Gs, Gs, Gs, Gd, Gd, Gd, Gd, Gd, Gd^Fetd, Gd^Ecf, Gd^Fetd, Gs^Fms, Gs^Fms, Gs^Fms
Rp, Gs, Re, Rp, Rp, Rp, Re, Rp, Rp, Gs, Gs, Gs, Gs, Gs, Gs, Gs, Gs, Gs, Gs, Gs, Gs, Gs, Gs, Gs, Gs, Gs, Gs, Gs, Gd, Gs, Gd, Gd, Gs, Gs, Gs, Gs, Rp, Rp, Re, Re, Re, Rp, Gs, Gs, Gs, Gs, Gs, Gs, Gs, Gs, Gs, Gs, Gs, Gs, Gs, Gs, Gd, Gs, Gs, Gs, Gs, Gs, Gs, Gs, Gs, Gd, Gd^Fetd, Gd^Ecf, Gd^Fetd, Gd^Fetd, Gs^Fms, Gs^Fms
Re, Rp, Re, Re, Re, Re, Rp, Re, Re, Rp, Rp, Gs, Gs, Gs, Gs, Gs, Gs, Gs, Gs, Gs, Gs, Gs, Gs, Gs, Gs, Gs, Gs, Gs, Gs, Gd, Gs, Gs, Gs, Gs, Re, Rp, Re, Re, Re, Re, Re, Re, Gs, Gs, Gs, Gs, Gs, Gs, Gs, Gs, Gs, Gs, Gs, Gs, Gd, Gd, Gd, Gd, Gd, Gs, Gs, Gs, Gs, Gs, Gs, Gd, Gd, Gd^Ecf, Gd^Fetd, Gd^Fetd, Gs^Fms, Gs^Fms
Rp, Re, Rp, Rp, Rp, Rp, Gd^Ecf, Rp, Re, Re, Re, Re, Rp, Gs, Gs, Gs, Gs, Gs, Gs, Gs, Gs, Gs, Gs, Gs, Rp, Rp, Re, Gs, Gs, Gs, Gs, Gs, Rp, Rp, Re, Re, Re, Re, Rp, Rp, Re, Re, Gs, Gs, Gs, Gs, Gs, Gs, Gs, Gs, Gs, Gs, Gs, Gs, Gd, Gd, Rd, Gd, Gd, Gs, Gs, Gs, Gs, Gs, Gs, Gs, Gs, Gd, Gd, Gd^Fetd, Gs^Fms, Gs^Fms
Gd^Fetd, Rp, Hhd, Gd^Fetd, Hhd, Gg, Hhd, Gd^Fetd, Gd^Ecf, Rp, Rp, Re, Re, Rp, Re, Gs, Gs, Gs, Gs, Gs, Gs, Gs, Rp, Rp, Re, Re, Re, Rp, Rp, Gs, Rp, Rp, Re, Re, Re, Rp, Hh, Hh, Hh, Re, Re, Rp, Gs, Gs, Gs, Gs, Gs, Gs, Gs, Gs, Gs, Gs, Gd, Gs, Gs, Gd, Gd, Gd, Gd, Gs, Gs, Gs, Gs, Gs, Gs, Gs, Gs, Gs, Gd, Gd^Fetd, Gs^Fms, Gs^Fms
Hhd, Hhd, Md, Md, Md, Hhd, Md, Md, Md, Gd^Ecf, Gd^Fetd, Rp, Re, Re, Re, Re, Re, Gs, Gs, Gs, Rp, Rp, Re, Re, Rp, Rp, Re, Rp, Re, Re, Re, Re, Rp, Rp, Hh, Hh, Hh, Hh, Hh, Rp, Re, Rp, Gs, Gs, Gs, Gs, Gs, Gs, Gs, Gs, Gs, Gd, Gs, Gd, Gd, Gs, Gs, Gd, Gd, Gd, Gd, Gs, Gs, Gs, Gs, Gs, Gs, Gs, Gd, Gd^Fetd, Gd^Fetd, Gs^Fms
Md, Md, Md, Md, Md, Md, Md, Md, Md, Md, Md, Hhd, Hhd, Rp, Rp, Re, Re, Rp, Re, Re, Re, Re, Rp, Re, Gs, Gs, Gs, Re, Rp, Rp, Re, Rp, Gs, Gs, Hh, Hh, Hh, Hh, Hh, Rp, Re, Rp, Gs, Gs, Gs, Gs, Gs, Gs, Gs, Gs, Gs, Gs, Gd, Gd, Gs, Gs, Gs, Gd, Gs, Gd, Gd, Gs, Gs, Gs, Gs, Gs, Gs, Gs, Gd, Gd, Gd^Ecf, Gd^Fetd
Md, Md, Md, Md, Md, Md, Md, Md, Md, Md, Md, Md, Md, Hhd, Hhd, Rp, Re, Re, Re, Rp, Rp, Re, Gs, Gs, Gs, Gs, Gd, Gs, Gs, Rp, Gs, Gs, Gs, Gs, Gs, Hh, Hh, Hh, Hh, Re, Re, Re, Gs, Gs, Gs, Gs, Gs, Gs, Gs, Gs, Gs, Gd, Gd, Gs, Gs, Gs, Gs, Gs, Gd, Gs, Gs, Gs, Gs, Gs, Gs, Gs, Gs, Gd, Gd, Gd, Gd^Fetd, Gd^Fetd
Md, Md, Md, Md, Md^Xm, Md^Xm, Md^Xm, Md, Md, Md, Md, Md, Md, Hhd, Md, Hhd, Re, Re, Rp, Rp, Gs, Gs, Gs, Gs, Gd, Gd, Gs, Gs, Gs, Gs, Gd, Gs, Gs, Gs, Gs, Hh, Hh, Hh, Gs, Rp, Re, Rp, Gs, Gs, Gs, Gs, Gs, Gs, Gs, Gs, Gd, Gd, Gs, Gs, Gs, Gs, Gs, Gs, Gs, Gd, Gs, Gd, Gs, Gs, Gs, Gs, Gs, Gd, Gd^Fetd, Gd^Ecf, Gd^Ecf, Gd^Fetd
Md, Md, Md, Md^Xm, Md^Xm, Md^Xm, Md^Xm, Md, Md, Md, Md, Md, Md, Md, Md, Md, Rp, Re, Rp, Gs, Gs, Gs, Gs, Gs, Gs, Gs, Gs, Gs, Gs, Gs, Gs, Gd, Gd, Gs, Gs, Gs, Gs, Gs, Gs, Rp, Re, Rp, Gs, Gs, Gs, Gs, Gs, Gs, Gs, Gs, Gd, Gs, Gs, Gs, Gd, Gd, Gs, Gs, Gs, Gd, Gd, Gd, Gs, Gs, Gs, Gs, Gs, Gd, Gd^Fetd, Gd^Ecf, Gd^Ecf, Gd^Fetd
Md, Md, Md^Xm, Md^Xm, Md^Xm, Md^Xm, Md^Xm, Md, Md, Md, Md, Md, Md, Md, Md, Md, Re, Re, Rp, Gs, Gs, Gs, Gs, Gs, Gs, Gs, Gd, Gs, Gd, Gs, Gs, Gs, Gs, Gs, Gs, Gs, Gs, Gs, Gs, Rp, Re, Rp, Gs, Gs, Gs, Gs, Gs, Gs, Gd, Gd, Gd, Gs, Gs, Gd, Gd, Gs, Gd, Gd, Gs, Gs, Gs, Gd, Gs, Gs, Gs, Gs, Gd, Gd, Gd^Ecf, Gd^Ecf, Gd^Fetd, Gd^Fetd
Md, Md, Md^Xm, Md^Xm, Md^Xm, Md^Xm, Md^Xm, Md, Md, Md, Hhd, Hhd, Hhd, Md, Re, Re, Re, Re, Rp, Gs, Gs, Gs, Gs, Gs, Gs, Gs, Gd, Gd, Gs, Gd, Gs, Gs, Gd, Gs, Gs, Gs, Gs, Gs, Gs, Re, Re, Re, Gs, Gs, Gs, Gs, Gs, Gs, Gs, Gs, Gs, Gd, Gs, Gs, Gs, Gs, Gd, Gd, Gd, Gs, Gd, Gd, Gs, Gs, Gs, Gd, Gd^Fetd, Gd^Ecf, Gd^Fetd, Gd^Fetd, Gs^Fms, Gs^Fms
Md, Md, Md, Md^Xm, Md^Xm, Md^Xm, Md, Md, Md, Md, Hhd, Hhd, Rp, Re, Re, Re, Rp, Rp, Gs, Gs, Gs, Gs, Gs, Gs, Gs, Gs, Gs, Gd, Gs, Gs, Gs, Gd, Gd, Gd, Gs, Gs, Gs, Gs, Gs, Re, Re, Rp, Gs, Gs, Gs, Gs, Gs, Gs, Gs, Gs, Gs, Gs, Gs, Gs, Gs, Gs, Gs, Gd, Gs, Gd, Gs, Gs, Gs, Gs, Gd, Gd, Gd^Fetd, Gd^Fetd, Gd^Fetd, Gs^Fms, Gs^Fms, Gs^Fms
Md, Md, Md, Md, Md, Md, Md, Md, Md, Md, Re, Re, Re, Re, Rp, Rp, Gs, Gs, Gs, Gs, Gs, Gs, Gs, Gs, Gs, Gs, Gs, Gd, Gs, Gs, Gs, Gd, Gs, Gd, Gs, Gs, Gs, Gs, Gs, Rp, Re, Re, Gs, Gs, Gs, Gs, Gs, Gs, Gs, Gs, Gs, Gs, Gs, Gs, Gs, Gs, Gs, Gs, Gs, Gs, Gs, Gs, Gd, Gd^Ecf, Gd^Ecf, Gd^Ecf, Gd^Fetd, Gd^Fetd, Gd^Fetd, Gs^Fms, Gs^Fms, Gs^Fms
Md, Md, Md, Md, Md, Md, Md, Md, Md, Md, Rp, Re, Rp, Re, Gs, Gs, Gs, Gs, Gs, Gs, Gs, Gs, Gs, Gs, Gs, Gs, Gs, Gd, Gs, Gs, Gs, Gs, Gs, Gd, Gs, Gs, Gs, Gs, Gs, Re, Rp, Re, Gs, Gs, Gs, Gs, Gs, Gs, Gs, Gs, Gs, Gs, Gs, Gs, Gs, Gs, Gs, Gs, Gs, Gs, Gs, Gd, Gd^Ecf, Gd^Ecf, Gd^Fetd, Gd^Fetd, Gs^Fms, Gd^Fetd, Gs^Fms, Gs^Fms, Gs^Fms, Gs^Fms
Gg, Md, Md, Md, Md, Md, Gg, Md, Md, Md, Rp, Re, Rp, Gs, Gs, Gs, Gs, Gs, Gs, Gs, Gs, Gs, Gs, Gs, Gs, Gs, Gs, Gs, Gs, Gs, Gs, Gs, Gs, Gs, Gs, Gs, Gs, Gs, Gs, Rp, Rp, Re, Gs, Gs, Gs, Gs, Gs, Gs, Gs, Gs, Gs, Gs, Gs, Gs, Gs, Gs, Gs, Gs, Gs, Gs, Gs, Gd, Gd^Fetd, Gd^Ecf, Gs^Fms, Gd^Fetd, Gs^Fms, Gs^Fms, Gs^Fms, Gs^Fms, Gs^Fms, Gs^Fms
