Xu, Urb, Xu, Urb, Xu, Urb, Urb, Urb, Xu, Urb, Xu, Urb, Xu
Xu, Xu, Ql^Ii, Xu, Xu, Urb, Urb, Urb, Xu, Xu, Ql^Ii, Xu, Xu
Xu, Ql^Ii, Urb^Ii, Urb^Ii, Urb, Urb, 1 Urb, Urb, Urb, Urb^Ii, Urb^Ii, Ql^Ii, Xu
Xu, Ql^Ii, Urb^Ii, Urb, Urb, Urb, Urb, Urb, Urb, Urb, Urb^Ii, Ql^Ii, Xu
Xu, Urb^Ii, Urb, Urb, Urb, Urb, Urb, Urb, Urb, Urb, Urb, Urb^Ii, Xu
Xu, Urb, Urb, Urb, Urb, Urb, Urb, Urb, Urb, Urb, Urb, Urb, Xu
Xu, Urb, Urb, Urb, Urb, Urb, Urb, Urb, Urb, Urb, Urb, Urb, Xu
Xu, Urb, Urb, Urb, Urb, Urb, Urb, Urb, Urb, Urb, Urb, Urb, Xu
Xu, Urb, Urb, Urb, Urb, Urb, Urb, Urb, Urb, Urb, Urb, Urb, Xu
Xu, Urb, Urb, Urb, Urb, Urb, Urb, Urb, Urb, Urb, Urb, Urb, Xu
Xu, Urb, Urb, Urb, Urb, Urb, Urb, Urb, Urb, Urb, Urb, Urb, Xu
Xu, Urb, Urb, Urb, Urb, Urb, Urb, Urb, Urb, Urb, Urb, Urb, Xu
Xu, Urb, Urb, Urb, Urb, Urb, Urb, Urb, Urb, Urb, Urb, Urb, Xu
Xu, Urb^Ii, Urb^Ii, Urb, Urb, Urb, Urb, Urb, Urb, Urb, Urb^Ii, Urb^Ii, Xu
Xu, Ql^Ii, Ql^Ii, Urb^Ii, Urb, Urb, Urb, Urb, Urb, Urb^Ii, Ql^Ii, Ql^Ii, Xu
Xu, Ql^Ii, Xu, Urb^Ii, Xu, Urb, Urb, Urb, Xu, Urb^Ii, Xu, Ql^Ii, Xu
Xu, Xu, Xu, Xu, Xu, Urb, Urb, Urb, Xu, Xu, Xu, Xu, Xu
